F1,F2,F3,F4,F5,F6,F7,F8,F9,F10,F11,F12,F13,F14,F15,F16,F17,F18,F19,F20,F21,F22,F23,F24,F25,F26,F27,F28,F29,F30,F31,F32,F33,F34,F35,Classe
1,20,30,3,3,30,1.25,2.0,3,0,17,0,16,15,17,0.9709505941661296,2.7414594653213467,0.62,4,15,15,15,0.7369655941662062,0.5590169943749475,0.7302967433402214,0.7482202261124646,0.7664188081933919,4.907982225817569,2.1728071751357785,27.36823542217665,-0.2,26,49,20,4.015212434638444,Humana
1,22,28,3,4,33,1.2941176470588236,1.6470588235294117,3,0,24,1,17,17,17,0.9895875209335165,3.449289781969616,0.68,5,11,16,17,0.8365012677171205,0.5703152773430975,0.9665692191267637,0.8129573506520736,1.5729223880492849,6.230634559275256,4.335708999205066,41.85325160212407,-0.12,32,50,23,4.224117662343592,Humana
0,26,24,6,4,26,1.8571428571428572,1.8461538461538463,2,0,17,2,14,13,18,0.9988455357066628,2.4836263809196426,0.54,12,11,13,13,0.9434164716336324,1.5050933932646768,1.0262818510866412,1.2968252888897478,1.4989921132503559,5.93666594340229,4.665995598359631,38.79852748890853,0.04,31,44,26,4.53421902118034,Aleatória
1,23,27,12,11,11,3.8333333333333335,4.5,0,3,3,1,6,6,17,0.9953784385316868,0.6499230723708768,0.24,17,21,5,6,0.8889686876112561,3.804237403504442,3.304037933599835,3.5784850922639815,1.2495340306450915,2.7758529982782485,3.20477035210638,9.859418044077136,-0.08,28,50,18,3.7343497272787918,Humana
0,31,19,5,3,25,2.3846153846153846,1.4615384615384615,1,0,12,2,13,13,17,0.9580420219377606,2.041959842896035,0.52,18,6,12,13,0.6896598793878495,1.2113858267710478,0.7457969011409737,1.1067303515337046,1.1735231515772555,4.5659037832438285,3.5787299586921493,23.634695068762166,0.24,26,50,21,4.154133293889817,Aleatória
0,26,24,5,5,38,1.3,1.263157894736842,6,1,35,0,20,19,17,0.9988455357066628,4.9001632625862594,0.78,6,5,19,19,0.9434164716336324,0.9539392014169457,0.90856192113853,0.9322902032152739,3.399836432311657,6.808032709173351,13.283212525834191,47.56789269606105,0.04,22,49,20,3.345052550151177,Humana
0,27,23,5,4,26,1.9285714285714286,1.7692307692307692,2,0,18,1,14,13,18,0.9953784385316868,2.5706808436676853,0.54,13,10,13,13,0.8889686876112561,1.486332289048915,1.186711432349347,1.3527394346481239,1.2575177849666128,6.286577540714674,3.0227146546666703,42.586010253311045,0.08,29,49,21,4.2675959232131575,Humana
1,22,28,4,5,25,1.6923076923076923,2.1538461538461537,2,1,13,1,13,13,17,0.9895875209335165,2.0614557962760203,0.52,9,15,12,13,0.8365012677171205,0.9101661204768638,1.2917581249035897,1.1409536133993328,1.0830101427023169,4.902766951227088,3.215289256198346,28.035521982508364,-0.12,31,50,27,4.599011412296559,Aleatória
1,19,31,6,9,22,1.7272727272727273,2.5833333333333335,2,2,12,3,11,12,18,0.9580420219377606,1.8784035775093701,0.46,8,19,11,11,0.6896598793878495,1.4200453956193917,2.253084305765962,1.9482918697746154,2.2242297884983686,5.150077282250748,7.462278376533705,30.016208023846154,-0.24,32,49,27,4.544876086303667,Aleatória
0,26,24,5,6,26,1.8571428571428572,1.8461538461538463,3,1,17,1,14,13,18,0.9988455357066628,2.459349507491768,0.54,12,11,13,13,0.9434164716336324,1.3014905113063284,1.4058205294228507,1.3527394346481239,1.6166092027204209,6.062745714548984,4.772751180631573,40.230414046747754,0.04,30,45,26,4.544876086303668,Aleatória
-1,25,25,4,4,36,1.3888888888888888,1.3157894736842106,6,0,30,0,18,19,17,0.9999999997114609,4.218103839404621,0.74,7,6,18,18,1.0,0.8258927081843613,0.7981974151633211,0.8126106150471841,2.2988793437873314,6.67494170206574,7.0780014096640365,46.31107169344111,0.0,25,49,18,3.7401032600285835,Humana
0,28,22,6,5,21,2.5454545454545454,2.0,0,1,11,1,11,11,17,0.9895875209335165,1.710672382427448,0.44,17,11,11,10,0.8365012677171205,1.9708621262435273,1.348399724926484,1.7104443383842527,1.1526213176572417,5.1001595118891165,2.8397012352772184,30.083191913527294,0.12,28,48,26,4.526294499949898,Aleatória
0,29,21,4,3,30,1.9333333333333333,1.3125,1,0,19,1,15,16,17,0.9814538947451146,2.841760018017004,0.62,14,5,15,15,0.7858751946471527,0.9285592184789412,0.6817945071647321,0.8679757449724973,1.1306489547817746,5.610768249736607,3.057400567748238,35.37143447342517,0.16,26,47,19,3.9638096525384374,Aleatória
0,26,24,4,5,25,2.0,1.8461538461538463,3,1,15,1,13,13,17,0.9988455357066628,2.2202702538204666,0.52,13,11,13,12,0.9434164716336324,1.1766968108291043,1.2917581249035897,1.2379597645716216,0.997550381093818,5.66916082028276,2.648365408983169,36.366747287691915,0.04,28,47,23,4.273911011375186,Humana
1,21,29,3,11,18,2.3333333333333335,2.9,0,2,4,8,9,10,16,0.9814538947451146,1.4406942770761604,0.38,12,19,9,9,0.7858751946471527,0.4714045207910317,2.913760456866693,2.1572527928336003,2.997058831173011,4.734949713658972,12.007899659863934,26.684349028202433,-0.16,27,48,17,3.938003326284241,Aleatória
-1,25,25,9,4,26,1.9230769230769231,1.7857142857142858,2,0,17,5,13,14,18,0.9999999997114609,2.4836263809196426,0.54,12,11,13,13,1.0,2.1289773081689307,1.0809104250301114,1.671187284841256,2.9963695691130865,5.93666594340229,12.658048062189046,38.798527488908526,0.0,28,48,25,4.410099326733673,Humana
1,20,30,4,7,26,1.5384615384615385,2.142857142857143,1,2,16,3,13,14,18,0.9709505941661296,2.3850366873488547,0.54,7,16,13,13,0.7369655941662062,0.9294650748918902,1.7261494247992248,1.4325244152454604,2.150787534086903,5.681955142933588,7.333615130544198,35.86370287993179,-0.2,30,49,28,4.5941078799230235,Aleatória
1,23,27,4,5,23,1.9166666666666667,2.25,0,1,6,1,12,12,18,0.9953784385316868,2.1282856951076847,0.48,11,15,12,11,0.8889686876112561,0.8620067027323834,1.0897247358851685,0.9965217285917831,1.3485133392142319,5.473572158812186,4.577094234436893,33.48265949937866,-0.08,29,47,23,4.2446723598980896,Aleatória
1,19,31,6,16,25,1.4615384615384615,2.3846153846153846,3,3,22,10,13,13,17,0.9580420219377606,3.0805194367184243,0.52,6,18,13,12,0.6896598793878495,1.3367805536140587,4.010341660842177,3.0245543463596154,3.9602225246816296,6.776461954091002,18.19015729780478,47.280105379798904,-0.24,20,48,18,3.465495989468814,Humana
-1,25,25,3,3,29,1.6666666666666667,1.6666666666666667,2,0,16,0,15,15,18,0.9999999997114609,2.6000000000000005,0.6,10,10,14,15,1.0,0.7888106377466154,0.7888106377466155,0.7888106377466154,0.664049771572406,4.78470641784251,1.9132653061224494,26.303315710234223,0.0,28,50,23,4.4250983688183005,Aleatória
1,24,26,4,4,25,1.8461538461538463,2.0,2,0,14,0,13,13,18,0.9988455357066628,2.1469979040511427,0.52,11,13,12,13,0.9434164716336324,1.166596222161777,1.1094003924504583,1.1409536133993328,0.7722652970033497,5.192426644104978,2.042066115702479,31.496017607369303,-0.04,31,50,26,4.588354347173232,Aleatória
1,20,30,3,8,26,1.5384615384615385,2.142857142857143,2,2,17,5,13,14,18,0.9709505941661296,2.4836263809196426,0.54,7,16,13,13,0.7369655941662062,0.7457969011409736,1.9948914348241347,1.5564371399593104,2.5456909626167374,5.921000148047559,9.737811486374698,38.73646041333114,-0.2,28,49,23,4.24684334837874,Aleatória
1,24,26,6,5,21,2.1818181818181817,2.3636363636363638,0,1,9,1,11,11,17,0.9988455357066628,1.5894653189044423,0.44,13,15,10,11,0.9434164716336324,1.465865045145191,1.2984415324623362,1.3876670474976134,1.0358234528687813,4.188629973916623,3.4635561531802033,20.327568413963984,-0.04,31,50,25,4.49564429268431,Aleatória
1,24,26,7,3,26,1.8461538461538463,1.8571428571428572,2,0,14,4,13,14,18,0.9988455357066628,2.2645970944077445,0.54,11,12,13,13,0.9434164716336324,1.6098807335735654,0.832993127835043,1.26794390878694,2.4597475266470914,4.804174466673884,10.295807173059671,26.588334733834696,-0.04,29,49,26,4.51205489055743,Aleatória
1,23,27,4,4,27,1.6428571428571428,1.9285714285714286,2,0,15,0,14,14,18,0.9953784385316868,2.342306555513176,0.56,9,13,13,14,0.8889686876112561,0.9715336077668174,0.9609731462195507,0.9767710236555246,0.8986438666546236,5.064826826335768,2.5377048242729274,29.73440703260008,-0.08,29,50,27,4.59901141229656,Aleatória
0,27,23,6,7,26,1.9285714285714286,1.7692307692307692,4,1,18,1,14,13,18,0.9953784385316868,2.5706808436676853,0.54,13,10,13,13,0.8889686876112561,1.486332289048915,1.6245163139956058,1.5564371399593109,2.0741898554960385,6.293641314167839,6.528932048547559,42.596561889904514,0.08,30,48,25,4.439337978210768,Humana
-1,25,25,4,5,31,1.5625,1.5625,3,1,24,1,16,16,17,0.9999999997114609,3.392698041382403,0.64,9,9,15,16,1.0,1.0588171466310885,1.1709371246996996,1.1162856937182344,1.8650212606322596,6.535961993691053,5.077908039425713,44.961630174158266,0.0,27,50,23,4.249014336859389,Humana
1,24,26,4,5,29,1.6,1.7333333333333334,0,1,16,1,15,15,17,0.9988455357066628,2.6907248094147422,0.6,9,11,14,15,0.9434164716336324,0.7999999999999999,1.0624918300339485,0.9428090415820631,1.9003494744388467,4.894653551999984,6.731250000000001,25.926162205060887,-0.04,28,50,23,4.25476786960918,Humana
-1,25,25,2,2,43,1.1363636363636365,1.1363636363636365,6,0,38,0,22,22,16,0.9999999997114609,5.368947755380005,0.88,3,3,21,22,1.0,0.34317429251230674,0.34317429251230674,0.34317429251230674,2.1192517713040706,6.622887990222122,5.491228070175442,45.7160712088564,0.0,22,50,14,2.9451720035002102,Humana
-1,25,25,5,4,29,1.6666666666666667,1.6666666666666667,3,0,19,1,15,15,18,0.9999999997114609,2.7856776554368237,0.6,10,10,15,14,1.0,1.0749676997731399,1.0749676997731399,1.0749676997731399,1.657771933451921,5.905390895393422,4.81508875739645,38.35646721224359,0.0,27,48,26,4.5670402169265785,Aleatória
1,11,39,11,39,1,11.0,39.0,0,7,0,28,1,1,13,0.7601675026734266,0.19595917942265428,0.04,10,38,0,1,0.3584539709124763,0.0,0.0,14.0,0.0,4.694855340334422,1.0,23.04166666666665,-0.56,14,50,6,1.1936404332857726,Humana
0,30,20,3,4,34,1.6666666666666667,1.1764705882352942,4,0,26,1,18,17,17,0.9709505941661296,3.7000000000000006,0.7,12,3,17,17,0.7369655941662062,0.816496580927726,0.7058823529411764,0.8030553898602969,1.7226252254053394,6.416362308254196,4.76886716872296,43.749010357167805,0.2,24,49,16,3.6673863476819224,Humana
0,27,23,2,3,38,1.35,1.2105263157894737,4,0,29,1,20,19,17,0.9953784385316868,4.225115383039852,0.78,7,4,19,19,0.8889686876112561,0.4769696007084729,0.5210260492953508,0.5037662231894487,1.5543870528023,6.100527389522975,4.492912561411043,40.089511308225056,0.08,24,49,16,3.552452511207945,Humana
1,21,29,3,6,31,1.3125,1.8125,3,1,21,3,16,16,17,0.9814538947451146,3.122563049803799,0.64,5,13,15,16,0.7858751946471527,0.582961190818051,1.3331705629813464,1.0588171466310885,2.6790957087285867,5.79832173645218,10.684371547548228,36.767893796875946,-0.16,31,50,24,4.354552444952287,Aleatória
1,17,33,3,8,21,1.5454545454545454,3.0,2,2,10,5,11,11,18,0.924818704684491,1.6144348856488455,0.44,6,22,10,11,0.5994620704162712,0.7820295697311479,2.04494943258218,1.7104443383842527,1.8066291930923009,4.685125822130923,6.246193622522261,26.01343851711664,-0.32,30,50,20,4.151400749996932,Aleatória
1,23,27,4,5,29,1.5333333333333334,1.8,1,1,18,1,15,15,18,0.9953784385316868,2.705549851693737,0.6,8,12,14,15,0.8889686876112561,0.8844332774281067,1.1075498483890769,1.0110500592068732,1.6699527206654177,5.588997543676208,5.3024574669187166,34.85487772104271,-0.08,30,50,27,4.588354347173232,Aleatória
1,23,27,5,7,24,1.9166666666666667,2.076923076923077,3,2,16,2,12,13,18,0.9953784385316868,2.3430749027719964,0.5,11,14,12,12,0.8889686876112561,1.2555432644432802,1.8589301497837805,1.6,1.640625,5.928410724761777,4.931640625,38.5785879940677,-0.08,29,49,25,4.501397825434102,Aleatória
0,27,23,6,4,27,1.9285714285714286,1.6428571428571428,1,0,15,2,14,14,18,0.9953784385316868,2.3846173697262216,0.56,13,9,14,13,0.8889686876112561,1.3343958351621,0.8949974347244049,1.1450871101343856,1.995134288698771,5.05839214391822,7.30610607276416,28.811924804186788,0.08,30,48,31,4.8385668472672965,Aleatória
-1,25,25,5,4,29,1.6666666666666667,1.6666666666666667,2,0,20,1,15,15,17,0.9999999997114609,2.891366458960192,0.6,10,10,15,14,1.0,1.1925695879998874,1.0749676997731397,1.1352924243950933,1.6351045767521495,6.115219209977728,4.405469678953626,40.65289256198342,0.0,32,48,26,4.561286684176787,Aleatória
1,20,30,5,5,30,1.3333333333333333,1.875,5,1,22,0,15,16,17,0.9709505941661296,3.1425467379181495,0.62,5,14,15,15,0.7369655941662062,1.0110500592068734,1.165922381636102,1.1267257546176117,1.8830975712574607,6.326276799443863,5.628597151303412,42.88380436878762,-0.2,24,49,20,3.985973783161348,Aleatória
1,23,27,3,4,27,1.6428571428571428,1.9285714285714286,2,0,15,1,14,14,17,0.9953784385316868,2.342306555513176,0.56,9,13,14,13,0.8889686876112561,0.8112726208286106,1.0996288798814748,0.9767710236555246,0.8986438666546235,5.064826826335768,2.537704824272928,29.73440703260008,-0.08,33,45,24,4.414441303694972,Humana
1,22,28,4,5,24,1.6923076923076923,2.3333333333333335,1,1,10,1,13,12,17,0.9895875209335165,1.8894443627691184,0.5,9,16,12,12,0.8365012677171205,0.9101661204768638,1.1055415967851334,1.0583005244258363,1.0124048384175728,4.047252713132071,3.571428571428571,18.39500506084787,-0.12,31,49,27,4.604764945046352,Humana
0,26,24,2,3,40,1.2380952380952381,1.2,6,0,34,1,21,20,17,0.9988455357066628,4.798708159494593,0.82,5,4,20,20,0.9434164716336324,0.4259177099999599,0.6000000000000001,0.518543698182178,2.327659776991627,6.62011447744219,7.433021379904456,45.72522521199115,0.04,23,49,13,3.2700100369385985,Humana
0,26,24,2,2,45,1.1304347826086956,1.0434782608695652,7,0,42,0,23,23,16,0.9988455357066628,5.895218401382597,0.92,3,1,23,22,0.9434164716336324,0.33678116053977536,0.20393111999232305,0.2817713347133852,2.931763649279748,6.766599740752967,9.595238095238093,47.15970783378104,0.04,19,48,10,2.3266347815795863,Humana
-1,25,25,12,10,23,2.0833333333333335,2.0833333333333335,2,2,18,2,12,12,18,0.9999999997114609,2.5396062686959953,0.48,13,13,12,11,1.0,3.0127045804208703,2.4986107250941583,2.767620317569269,2.8500045263008924,6.569330443711872,9.67607259193381,45.30662711295821,0.0,27,37,21,3.942495522291783,Humana
0,27,23,5,4,23,2.25,1.9166666666666667,0,0,11,1,12,12,18,0.9953784385316868,1.857309882599024,0.48,15,11,11,12,0.8889686876112561,1.479019945774904,1.114924013354971,1.3202482931462383,1.041596501048247,4.545355441113316,2.7576228948746846,23.70337299196958,0.08,29,50,25,4.51205489055743,Aleatória
-1,25,25,4,4,28,1.6666666666666667,1.7857142857142858,2,0,15,0,15,14,17,0.9999999997114609,2.458373446000424,0.58,10,11,14,14,1.0,0.9428090415820634,0.8601138984851641,0.9057879680388756,1.1275148173291993,4.8507073279494985,3.3697668557025855,26.45162564172142,0.0,30,49,27,4.588354347173232,Humana
-1,25,25,2,2,42,1.1363636363636365,1.1904761904761905,5,0,36,0,22,21,17,0.9999999997114609,5.114723843962645,0.86,3,4,21,21,1.0,0.34317429251230674,0.39267672624930106,0.3691746015438964,1.8268282862112641,6.515912705720975,4.3373015873015826,44.602618566967024,0.0,22,49,12,3.230994305917858,Humana
1,24,26,4,5,29,1.6,1.7333333333333334,2,1,18,1,15,15,18,0.9988455357066628,2.7422618401604177,0.6,9,11,15,14,0.9434164716336324,0.8793937305515279,1.18133634311129,1.043498389499902,1.75365097943861,5.495541142444607,5.329029571012075,33.48234495246715,-0.04,31,47,27,4.637586140792589,Aleatória
1,21,29,4,5,24,1.6153846153846154,2.4166666666666665,2,1,12,1,13,12,17,0.9814538947451146,1.9313207915827966,0.5,8,17,12,12,0.7858751946471527,0.8355984993230934,1.3819269959814167,1.2,0.9722222222222222,4.75580578597033,2.7777777777777777,26.57407873268693,-0.16,31,49,23,4.348798912202495,Aleatória
0,26,24,5,4,26,2.0,1.7142857142857142,3,0,18,1,13,14,17,0.9988455357066628,2.6092910914652667,0.54,13,10,13,13,0.9434164716336324,1.4142135623730951,1.2205719636167902,1.3250773199998753,1.1327518580549225,6.087944532817666,2.5938647460937503,40.27182468615706,0.04,26,49,18,3.9930483040155336,Humana
1,19,31,3,9,19,1.9,3.1,0,1,5,6,10,10,16,0.9580420219377606,1.42828568570857,0.4,9,21,9,10,0.6896598793878495,0.7000000000000001,2.2113344387495983,1.746424919657298,2.478130496046905,4.011390593656711,9.789035205589897,19.02998846597463,-0.24,26,50,22,4.249014336859389,Aleatória
-1,25,25,5,4,24,1.9230769230769231,2.0833333333333335,0,0,12,1,13,12,18,0.9999999997114609,1.9313207915827966,0.5,12,13,12,12,1.0,1.2064913185660093,1.114924013354971,1.1661903789690602,0.907933686048576,4.722490158748122,2.8114186851211067,26.3325762421925,0.0,30,47,25,4.507151358183894,Aleatória
1,24,26,3,4,34,1.3333333333333333,1.5294117647058822,2,0,25,1,18,17,17,0.9988455357066628,3.5958309192730407,0.7,6,9,17,17,0.9434164716336324,0.5773502691896257,0.9150793638884732,0.766651877999928,1.7624563572654584,6.2348564386050755,5.251736111111108,41.81077657132911,-0.04,28,48,21,4.197049999347146,Humana
0,27,23,2,4,38,1.4210526315789473,1.15,4,0,30,2,19,20,17,0.9953784385316868,4.323378308684077,0.78,8,3,19,19,0.8889686876112561,0.49372797471825575,0.653834841531101,0.5969459859909136,2.6959376693744534,6.262117697523025,11.486996364428586,41.88746455032644,0.08,21,46,10,2.9314903608422926,Humana
1,23,27,3,4,31,1.4375,1.6875,1,0,19,1,16,16,18,0.9953784385316868,2.9377542443165665,0.64,7,11,16,15,0.8889686876112561,0.7043392293490403,0.8454843286542927,0.7880950133074057,1.325742839521275,5.343832090917059,4.078201020529251,31.83315103544784,-0.08,31,48,25,4.398030705821853,Aleatória
-1,25,25,6,6,22,2.272727272727273,2.0833333333333335,2,1,11,0,11,12,18,0.9999999997114609,1.7912007146045918,0.46,14,13,11,11,1.0,1.6006197146962737,1.4976833963009524,1.5506569130545222,1.3179468196998165,4.7216981155795335,3.6344710454491547,25.904186664599596,0.0,25,48,21,4.251185325340039,Humana
1,22,28,4,5,24,1.8333333333333333,2.1538461538461537,1,1,14,1,12,13,17,0.9895875209335165,2.090454496036687,0.5,10,15,12,12,0.8365012677171205,0.9860132971832695,1.5112986695683461,1.296148139681572,0.8817334283548109,5.536772377167793,2.2959183673469394,35.02780556006472,-0.12,28,47,24,4.4250983688183,Humana
0,33,17,2,1,34,1.8333333333333333,1.0,0,0,20,1,18,17,15,0.924818704684491,3.4655446902326914,0.7,15,0,17,17,0.5994620704162712,0.37267799624996495,0.0,0.49487165930539356,0.2886751345948126,4.851759202654662,1.0833333333333326,25.03831944098762,0.32,15,49,5,1.8168296348165345,Humana
-1,25,25,3,3,35,1.3888888888888888,1.3888888888888888,4,0,27,0,18,18,16,0.9999999997114609,3.8576676891614197,0.72,7,7,17,18,1.0,0.7556372504853025,0.6781419786518724,0.7179359990733382,1.5189176983514376,6.356619211821818,3.6452006167306097,43.11758199626874,0.0,28,50,18,3.846143272171575,Humana
0,26,24,7,4,30,1.625,1.6,4,0,24,3,16,15,17,0.9988455357066628,3.381656398867277,0.62,10,9,15,15,0.9434164716336324,1.5761900266148114,1.083205120618128,1.360204428536001,2.491898691856389,6.61244010250522,8.921895660117848,45.703739791584354,0.04,27,49,21,4.1478182057277895,Humana
0,28,22,7,4,25,2.1538461538461537,1.6923076923076923,0,0,12,3,13,13,18,0.9895875209335165,2.1094074997496333,0.52,15,9,13,12,0.8365012677171205,1.5613679330911108,0.9101661204768638,1.298611001241087,2.355677958077737,4.542715417997652,9.408938134810711,22.810351254680516,0.12,29,48,28,4.664653803789035,Aleatória
1,22,28,5,4,27,1.5714285714285714,2.0,3,0,17,1,14,14,18,0.9895875209335165,2.49927989629013,0.56,8,14,13,14,0.8365012677171205,1.178030178747903,1.1338934190276817,1.175862688082452,1.3435777472137773,5.816892719525646,3.5439196089377862,37.665472492483524,-0.12,28,50,22,4.294663586209604,Aleatória
0,29,21,6,3,26,2.230769230769231,1.5,1,0,14,3,13,14,17,0.9814538947451146,2.2289908030317216,0.54,16,7,13,13,0.7858751946471527,1.4225570776082255,0.7319250547113999,1.1770554505237556,1.7876958026397045,4.9531481610912325,6.400319576512108,28.12389081703073,0.16,30,49,26,4.604764945046351,Aleatória
1,23,27,5,6,23,1.9166666666666667,2.25,2,2,14,1,12,12,18,0.9953784385316868,2.032141727340886,0.48,11,15,12,11,0.8889686876112561,1.3202482931462383,1.7380544678845176,1.552328000849763,1.1977300749192035,5.941752288321191,3.0693137556162737,39.25398521457655,-0.08,27,44,24,4.414441303694972,Humana
0,30,20,7,4,21,2.727272727272727,1.8181818181818181,1,0,10,3,11,11,17,0.9709505941661296,1.6632498309033434,0.44,19,9,10,11,0.7369655941662062,2.2193737483152187,0.9359663764533636,1.7627926754241194,1.67304206939691,4.577741109025575,4.911696468990494,24.37719192317225,0.2,32,50,25,4.398030705821852,Aleatória
1,22,28,7,9,13,3.142857142857143,4.0,0,2,4,2,7,7,17,0.9895875209335165,0.8009993757800314,0.28,15,21,7,6,0.8365012677171205,2.2314999074019015,2.7774602993176543,2.5555062599997598,0.7646304326184826,3.18940725074819,2.28951171875,12.865883918632342,-0.12,27,35,22,4.107922489127366,Aleatória
1,22,28,4,4,33,1.2941176470588236,1.6470588235294117,5,0,26,0,17,17,16,0.9895875209335165,3.6793477682872004,0.68,5,11,16,17,0.8365012677171205,0.823529411764706,0.9665692191267637,0.9150793638884733,1.6989688100935976,6.528646415637519,4.412027866948978,44.8690221858334,-0.12,28,50,21,4.129236619374021,Humana
0,26,24,5,4,26,1.8571428571428572,1.8461538461538463,2,0,15,1,14,13,18,0.9988455357066628,2.299652147608416,0.54,12,11,13,13,0.9434164716336324,1.1866605518454392,1.0262818510866412,1.1123449939023116,1.1015852691443075,5.296668315789301,3.334813988131818,32.00556689770955,0.04,29,49,28,4.642489673166124,Aleatória
1,21,29,6,5,24,1.75,2.230769230769231,2,1,13,1,12,13,18,0.9814538947451146,2.0024984394500787,0.5,9,16,12,12,0.7858751946471527,1.5343293866268306,1.1200169060431566,1.3564659966250536,1.4423669623848632,5.185542068687464,4.371455576559546,31.065882674858994,-0.16,29,48,25,4.457919564564537,Aleatória
1,22,28,4,4,27,1.5714285714285714,2.0,1,0,14,0,14,14,17,0.9895875209335165,2.342306555513176,0.56,8,14,14,13,0.8365012677171205,0.9035079029052513,1.0,0.9767710236555246,1.1285840727437961,4.728661787242224,3.2103005519174137,25.08057056443329,-0.12,32,47,28,4.648243205915917,Aleatória
0,28,22,4,4,25,2.1538461538461537,1.6923076923076923,1,0,13,0,13,13,17,0.9895875209335165,2.1469979040511427,0.52,15,9,13,12,0.8365012677171205,1.166596222161777,1.0658774200423857,1.1409536133993328,0.9276377198528332,4.646795817924876,2.3563223140495864,24.874911101122038,0.12,30,45,28,4.7081320646586,Humana
0,26,24,3,4,41,1.2380952380952381,1.1428571428571428,5,0,38,1,21,21,16,0.9988455357066628,5.319248067161372,0.84,5,3,21,20,0.9434164716336324,0.6098213559459856,0.63887656499994,0.6263307827602811,3.3232844720471175,6.815360738570385,13.031541314444189,47.6362392768654,0.04,23,48,15,2.969997547967329,Humana
0,30,20,5,4,26,2.142857142857143,1.5384615384615385,3,0,18,1,14,13,18,0.9709505941661296,2.5939159585460754,0.54,16,7,13,13,0.7369655941662062,1.4069796859708723,1.08240363688233,1.2968252888897478,1.09142131053033,6.156140385918435,2.5940524630823725,41.13785913336031,0.2,29,47,18,3.9887063270542353,Humana
-1,25,25,3,3,34,1.3888888888888888,1.4705882352941178,3,0,23,0,18,17,16,0.9999999997114609,3.448187929913334,0.7,7,8,17,17,1.0,0.5905636562630361,0.6960093862470137,0.6452337023220694,1.2242323417760133,5.686681597595519,3.3016147635524784,35.66226221439732,0.0,31,49,23,4.229871195093383,Humana
-1,25,25,2,2,41,1.1904761904761905,1.1904761904761905,6,0,34,0,21,21,15,0.9999999997114609,4.8676893902548874,0.84,4,4,21,20,1.0,0.39267672624930106,0.392676726249301,0.39267672624930094,1.5764815627361648,6.381452082969372,3.48529411764706,43.16663608769501,0.0,26,47,13,3.2669890480816934,Humana
0,27,23,6,3,31,1.6875,1.4375,3,0,21,3,16,16,17,0.9953784385316868,3.0968370961353457,0.64,11,7,16,15,0.8889686876112561,1.260890062614501,0.7043392293490403,1.0288798520721456,2.6723613450588353,5.857401876920244,11.23597173241105,37.72943898185806,0.08,28,46,25,4.370963042825406,Aleatória
0,28,22,6,5,22,2.3333333333333335,2.0,1,1,10,1,12,11,18,0.9895875209335165,1.7229045243425418,0.46,16,11,11,11,0.8365012677171205,1.5986105077709065,1.2792042981336627,1.4641268035202377,1.2766005823271311,4.50235770603276,3.528395994886299,22.98366178092843,0.12,31,44,28,4.691721466785482,Aleatória
0,28,22,3,3,38,1.4,1.1578947368421053,3,0,31,0,20,19,17,0.9895875209335165,4.392220395198765,0.78,8,3,19,19,0.8365012677171205,0.66332495807108,0.48808518397345807,0.5969459859909135,1.9726991729692787,6.529255093718543,5.584503206655683,44.839230090548725,0.12,26,49,16,3.5401860130162053,Humana
0,28,22,7,4,29,1.8666666666666667,1.4666666666666666,3,0,22,3,15,15,18,0.9895875209335165,3.1432467291003423,0.6,13,7,15,14,0.8365012677171205,1.5860503004493753,0.9568466729604883,1.3249737942901192,2.4329754338350855,6.360271578085807,9.289376702451536,43.04858299595138,0.12,29,46,21,4.143476228766491,Humana
0,34,16,5,2,29,2.2666666666666666,1.0666666666666667,0,0,19,3,15,15,17,0.9043814574359548,2.7856776554368237,0.6,19,1,14,15,0.5563933485243853,1.236482466066094,0.24944382578492946,1.0749676997731399,1.657771933451921,5.905390895393422,4.81508875739645,38.35646721224359,0.36,27,50,16,3.7442473597099624,Humana
-1,25,25,5,4,23,2.0833333333333335,2.0833333333333335,1,0,12,1,12,12,17,0.9999999997114609,1.9518196638009366,0.48,13,13,12,11,1.0,1.320248293146238,1.114924013354971,1.2219065248845982,0.6629619392992043,4.86353894319063,2.2584532179556516,26.779097824175388,0.0,29,44,22,4.176297424512727,Humana
0,27,23,4,3,26,1.9285714285714286,1.7692307692307692,1,0,12,1,14,13,18,0.9953784385316868,2.1467184258770406,0.54,13,10,13,13,0.8889686876112561,1.0996288798814748,0.696568087549032,0.9310966733315952,0.8484265973646229,4.342181412702237,2.7528040378144514,21.210044400190004,0.08,31,47,25,4.4743301624376555,Aleatória
0,29,21,7,5,25,2.230769230769231,1.6153846153846154,3,1,19,2,13,13,17,0.9814538947451146,2.6701310829245815,0.52,16,8,13,12,0.7858751946471527,2.0438969623979113,1.273303489018988,1.7303418275695372,1.7221644087246903,6.628010588969957,4.644854629817683,45.89211719860501,0.16,26,43,21,3.992640556327225,Humana
1,24,26,3,5,32,1.411764705882353,1.625,2,1,23,2,17,16,17,0.9988455357066628,3.3142721674599995,0.66,7,10,16,16,0.9434164716336324,0.6910200073218077,1.1110243021644486,0.925111364998409,2.022442480044828,6.183260306490882,6.9845226473134545,41.36756819929422,-0.04,28,49,28,4.561286684176785,Aleatória
1,23,27,4,10,25,1.7692307692307692,2.076923076923077,3,2,15,6,13,13,18,0.9953784385316868,2.308592644881292,0.52,10,14,13,12,0.8889686876112561,1.0490908997681427,2.36843143359087,1.8381235608228492,3.308832132173866,5.3727150239226695,14.50536895666496,32.20112682900847,-0.08,31,44,24,4.370963042825407,Aleatória
0,27,23,7,4,25,2.076923076923077,1.7692307692307692,1,0,12,3,13,13,18,0.9953784385316868,2.1094074997496333,0.52,14,10,12,13,0.8889686876112561,1.5913969896597848,0.890448992522325,1.2986110012410872,2.3556779580777363,4.542715417997652,9.408938134810704,22.810351254680516,0.08,33,50,30,4.762267390651493,Aleatória
0,28,22,4,4,38,1.4,1.1578947368421053,5,0,33,0,20,19,16,0.9895875209335165,4.631587200949584,0.78,8,3,19,19,0.8365012677171205,0.8,0.6698906348083083,0.749314830574485,2.77889529788194,6.731306931490559,9.667422626131884,46.84144697211105,0.12,23,48,17,3.2167879513617903,Humana
0,28,22,4,4,28,2.0,1.4666666666666666,2,0,19,0,14,15,17,0.9895875209335165,2.7647061326658218,0.58,14,7,14,14,0.8365012677171205,1.1338934190276817,0.9568466729604883,1.0794810925861054,1.0574710980473498,6.0043145891596295,2.5132611411911703,39.5543128761104,0.12,26,49,20,4.154133293889818,Humana
1,19,31,3,4,25,1.4615384615384615,2.3846153846153846,0,0,11,1,13,13,17,0.9580420219377606,2.032141727340886,0.52,6,18,13,12,0.6896598793878495,0.6343239424027171,1.0769230769230769,0.9970370305242862,0.8528015502369183,4.253753959159119,2.6405187074829928,20.304034895124435,-0.24,28,47,23,4.365209510075616,Aleatória
0,29,21,6,3,36,1.5263157894736843,1.1666666666666667,4,0,30,3,19,18,17,0.9814538947451146,4.227576137694034,0.74,10,3,18,18,0.7858751946471527,1.1862555441668048,0.49999999999999994,0.9362436797669607,3.596603501916775,6.635765062172381,16.98740000000001,45.90268754219729,0.16,27,44,20,3.572505304712351,Humana
1,16,34,2,7,23,1.3333333333333333,2.8333333333333335,2,3,13,5,12,12,17,0.9043814574359548,2.0123617964968425,0.48,4,22,12,11,0.5563933485243853,0.4714045207910317,1.9930434571835662,1.630865482565077,1.594832548745953,5.234583540942713,4.5588489934487235,31.11392919813281,-0.36,26,44,18,3.996630848284676,Humana
0,26,24,11,13,24,2.0,2.0,3,2,21,2,13,12,18,0.9988455357066628,2.9410882339705484,0.5,13,12,12,12,0.9434164716336324,2.660248687044705,3.3166247903554,2.9933259094191533,3.0424828878423305,6.768757979080202,10.574776785714285,47.20856025928029,0.04,19,39,17,3.3852658922577055,Humana
1,23,27,3,4,30,1.5333333333333334,1.6875,1,0,18,1,15,16,17,0.9953784385316868,2.806349942541023,0.62,8,11,15,15,0.8889686876112561,0.6182412330330469,1.0439558180306292,0.8679757449724974,1.4266319690953906,5.278015304338588,4.2674139983517,31.01597801782982,-0.08,31,49,26,4.571943749300114,Aleatória
1,21,29,3,8,31,1.3125,1.8125,4,2,27,5,16,16,17,0.9814538947451146,3.7829089336118034,0.64,5,13,16,15,0.7858751946471527,0.6817945071647321,2.1569292408421745,1.6189792308735773,3.1575202844273593,6.76350408767301,11.83948374315089,47.15393998455114,-0.16,23,47,16,3.267931954656495,Humana
0,26,24,6,4,24,2.0,2.0,2,0,13,2,13,12,18,0.9988455357066628,2.0024984394500787,0.5,13,12,12,12,0.9434164716336324,1.5191090506254998,1.0801234497346435,1.3266499161421599,1.3362434589241796,5.155654218147478,4.132231404958678,30.976330992966467,0.04,31,49,23,4.3873736406985255,Aleatória
0,26,24,3,7,31,1.625,1.5,2,1,21,4,16,16,18,0.9988455357066628,3.128961489056713,0.64,10,8,16,15,0.9434164716336324,0.6959705453537527,1.4577379737113252,1.1439378261076953,3.416126061843873,5.764233525895602,16.152381376698596,36.468808971789834,0.04,24,41,19,4.040109109154241,Humana
0,30,20,5,3,25,2.3076923076923075,1.5384615384615385,1,0,15,2,13,13,18,0.9709505941661296,2.2202702538204666,0.52,17,7,13,12,0.7369655941662062,1.4349813927828945,0.8426500884694863,1.2379597645716216,0.9975503810938181,5.66916082028276,2.6483654089831683,36.366747287691915,0.2,31,43,25,4.4743301624376555,Aleatória
0,28,22,6,5,26,2.0,1.6923076923076923,2,1,17,1,14,13,17,0.9895875209335165,2.45120378589786,0.54,14,9,13,13,0.8365012677171205,1.5118578920369088,1.2015768732164083,1.379847111866456,1.6203081813053837,6.111493203786268,4.59065975134749,40.7525737052475,0.12,30,48,27,4.5591156956961365,Aleatória
-1,25,25,3,3,29,1.6666666666666667,1.6666666666666667,2,0,15,0,15,15,18,0.9999999997114609,2.5768197453450257,0.6,10,10,15,14,1.0,0.7888106377466155,0.699205898780101,0.7453559924999299,0.6260990336999409,4.548896665419826,2.0399999999999996,23.219335172013345,0.0,28,46,20,4.191296466597355,Humana
0,29,21,4,3,23,2.4166666666666665,1.75,0,0,7,1,12,12,18,0.9814538947451146,1.8247191564731269,0.48,17,9,11,12,0.7858751946471527,1.0374916331657278,0.5951190357119042,0.9090593428863095,0.5007176664439806,4.0514262233836655,2.4504625379563585,18.845322118773982,0.16,30,50,20,4.14347622876649,Aleatória
0,29,21,9,3,26,2.0714285714285716,1.6153846153846154,1,0,15,6,14,13,18,0.9814538947451146,2.3682060721145026,0.54,15,8,13,13,0.7858751946471527,2.086154552358605,0.737820234355803,1.6033230238454341,3.315306062911611,5.172242108871394,14.815877895461009,29.773404515680564,0.16,30,48,27,4.586183358692582,Aleatória
0,27,23,6,7,15,3.375,2.875,0,2,5,1,8,8,18,0.9953784385316868,0.947417542586161,0.32,19,15,8,7,0.8889686876112561,1.5761900266148114,2.315032397181517,1.996089927833914,0.4877182125863164,3.416661822365611,1.9014994232987312,14.694243472790184,0.08,29,37,21,4.216193141113151,Aleatória
1,20,30,3,4,29,1.3333333333333333,2.0,2,0,19,1,15,15,18,0.9709505941661296,2.778488797889961,0.6,5,15,15,14,0.7369655941662062,0.5962847939999438,1.2110601416389966,1.0110500592068732,1.2829250514983248,5.904353963783716,3.260869565217392,38.615130607533054,-0.2,26,46,20,4.110655033020254,Humana
0,28,22,4,3,30,1.75,1.4666666666666666,2,0,19,1,16,15,17,0.9895875209335165,2.841760018017004,0.62,12,7,15,15,0.8365012677171205,0.9682458365518543,0.7180219742846006,0.8679757449724973,1.1306489547817749,5.610768249736607,3.057400567748238,35.37143447342517,0.12,28,48,25,4.528465488430549,Aleatória
1,24,26,6,8,16,2.6666666666666665,3.25,1,2,9,2,9,8,17,0.9988455357066628,1.3358143583597237,0.34,15,18,8,8,0.9434164716336324,2.0548046676563256,2.680951323690902,2.387974485904052,0.8212372754991287,5.554815084933146,2.2281479757752845,35.47700771251163,-0.04,26,44,21,4.1447375655087395,Humana
0,26,24,6,8,18,2.6,2.6666666666666665,0,1,7,2,10,9,18,0.9988455357066628,1.2789057822998533,0.38,16,15,9,9,0.9434164716336324,1.5620499351813308,2.1081851067789197,1.8413532299511475,1.409118685276316,3.9108083345453517,4.653843073176983,18.177283074483437,0.04,31,49,23,4.316827716832513,Aleatória
-1,25,25,3,5,32,1.4705882352941178,1.5625,4,1,22,2,17,16,18,0.9999999997114609,3.228683942413689,0.66,8,9,16,16,1.0,0.7759356446042893,0.998044963916957,0.8917538769431613,2.1336855639768517,5.92600771124307,7.858693043325211,38.47302624205555,0.0,29,49,23,4.281835532605627,Aleatória
1,21,29,3,6,23,1.75,2.4166666666666665,2,2,10,3,12,12,18,0.9814538947451146,1.8137254478007416,0.48,9,17,12,11,0.7858751946471527,0.82915619758885,1.552328000849763,1.288302069478359,1.481521442900062,4.115087066427754,4.915827804135081,19.296715790549428,-0.16,28,48,21,4.294663586209604,Aleatória
-1,25,25,2,4,39,1.25,1.25,5,0,32,2,20,20,15,0.9999999997114609,4.565084884205331,0.8,5,5,19,20,1.0,0.4330127018922193,0.698212002188447,0.5809475019311126,2.964505771171109,6.429843881098958,13.065843621399175,43.70573715835117,0.0,26,50,15,3.476714610004379,Humana
1,23,27,2,4,37,1.2105263157894737,1.4210526315789473,4,0,29,2,19,19,17,0.9953784385316868,4.154804447865145,0.76,4,8,18,19,0.8889686876112561,0.40768245749551757,0.8153649149910351,0.6531407182100452,2.4033408271224475,6.342313511790862,8.933884297520652,42.78888158272795,-0.08,28,50,18,3.953152587415111,Humana
0,27,23,2,3,40,1.2857142857142858,1.15,3,0,33,1,21,20,17,0.9953784385316868,4.7018719676316145,0.82,6,3,20,20,0.8889686876112561,0.45175395145262565,0.47696960070847283,0.46915570882125235,2.036786905463753,6.452165626553264,6.405741417092768,43.9430187541438,0.08,26,49,14,3.3941000652265476,Humana
-1,25,25,3,3,39,1.25,1.25,5,0,33,0,20,20,17,0.9999999997114609,4.651881339845205,0.8,5,5,20,19,1.0,0.5361902647381804,0.6224949798994366,0.5809475019311126,2.1994720237721133,6.636871170588997,6.481481481481481,45.91964972102723,0.0,25,48,19,3.6099116026646785,Humana
0,26,24,4,5,29,1.7333333333333334,1.6,2,1,21,1,15,15,18,0.9988455357066628,2.9933259094191533,0.6,11,9,14,15,0.9434164716336324,1.1234866364235143,1.1430952132988164,1.1352924243950933,1.4984240084168294,6.356999539774091,4.004161712247323,43.182079081632615,0.04,28,50,23,4.276081999855835,Humana
1,18,32,5,11,18,2.0,3.2,1,4,11,6,9,10,17,0.9426831889669534,1.611086589851706,0.38,9,22,9,9,0.6438561897747247,1.632993161855452,3.1240998703626617,2.5998082179428357,1.8446970301911827,5.8268006266677,5.9973501746842235,37.926153559631864,-0.28,26,39,23,4.176297424512728,Humana
1,20,30,3,8,27,1.4285714285714286,2.142857142857143,2,1,18,5,14,14,17,0.9709505941661296,2.6165626306282066,0.56,6,16,13,14,0.7369655941662062,0.7284313590846836,1.8844151368961315,1.4725377234348789,2.7885319486530284,6.004366723446002,11.628517647058821,39.59362492552502,-0.2,28,50,24,4.420194836444764,Humana
-1,25,25,4,4,30,1.6666666666666667,1.5625,2,0,21,0,15,16,18,0.9999999997114609,3.0192051934242565,0.62,10,9,15,15,1.0,0.9428090415820632,1.0588171466310885,1.0057069205238642,1.4019949438037522,6.190955608478157,3.5179850632525547,41.570297723014434,0.0,30,46,24,4.303149662852281,Humana
0,50,0,50,0,0,50.0,0.0,0,0,0,50,1,0,10,-1.4426951601859516e-10,0.13999999999999999,0.02,49,0,0,0,0.0,0.0,0.0,0.0,0.0,6.857142857142859,0.0,48.02040816326532,1.0,12,0,1,-0.0,Humana
0,28,22,3,3,36,1.4736842105263157,1.2222222222222223,3,0,27,0,19,18,15,0.9895875209335165,3.897742936623707,0.74,9,4,18,18,0.8365012677171205,0.5954583420518295,0.628539361054709,0.6245524328806131,1.5734316351820388,6.196420149108264,4.23012666750831,41.342137492401264,0.12,27,49,19,3.8239791415486635,Humana
-1,25,25,5,4,27,1.7857142857142858,1.7857142857142858,1,0,14,1,14,14,18,0.9999999997114609,2.3337523433303717,0.56,11,11,13,14,1.0,1.0126747770541304,1.0126747770541304,1.0126747770541304,1.4696454921471684,4.776696359334328,4.844657310462611,25.447407038929782,0.0,30,50,26,4.544876086303668,Humana
0,30,20,6,3,23,2.5,1.6666666666666667,2,0,12,3,12,12,18,0.9709505941661296,1.857309882599024,0.48,18,8,12,11,0.7369655941662062,1.7559422921421233,0.74535599249993,1.411756195508118,1.2739381866931418,5.107242968694128,3.706212288603723,30.38318271312574,0.2,32,45,25,4.484987227560984,Humana
0,31,19,4,1,36,1.7222222222222223,1.0,3,0,28,3,18,19,16,0.9580420219377606,3.994045568092582,0.74,13,0,18,18,0.6896598793878495,0.8695819912499182,0.0,0.7058143166054376,2.1496286070930855,6.399167033609452,7.130842528014037,43.46060596257673,0.24,25,49,12,3.3022996624760266,Humana
1,21,29,3,6,26,1.6153846153846154,2.0714285714285716,2,3,17,3,13,14,18,0.9814538947451146,2.4674683381960554,0.54,8,15,13,13,0.7858751946471527,0.8355984993230935,1.751092953161609,1.406432410818335,1.7017409841575528,6.006771155142104,4.796375237813101,39.7059823732457,-0.16,29,48,23,4.370963042825407,Humana
0,28,22,4,5,24,2.1538461538461537,1.8333333333333333,2,1,14,1,13,12,18,0.9895875209335165,2.1095023109728985,0.5,15,10,12,12,0.8365012677171205,1.2917581249035897,1.2133516482134197,1.2649110640673518,0.8300978857941994,5.464838709905805,2.3124999999999996,34.00795354121954,0.12,30,47,26,4.517808423307221,Humana
0,26,24,5,5,26,1.8571428571428572,1.8461538461538463,1,1,16,0,14,13,18,0.9988455357066628,2.359745749016194,0.54,12,11,13,13,0.9434164716336324,1.2453996981544782,1.2307692307692308,1.2383891479481843,1.3356690440702204,5.7444201468942495,3.6710471996697396,37.037735177073735,0.04,28,48,27,4.582600814423441,Aleatória
1,24,26,4,4,27,1.7142857142857142,1.8571428571428572,1,0,15,0,14,14,18,0.9988455357066628,2.342306555513176,0.56,10,12,13,14,0.9434164716336324,0.9583148474999098,0.989743318610787,0.9767710236555247,0.8986438666546233,5.064826826335768,2.537704824272926,29.73440703260008,-0.04,32,50,30,4.81149918427085,Aleatória
0,27,23,3,3,32,1.588235294117647,1.4375,1,0,20,0,17,16,16,0.9953784385316868,3.082920693109053,0.66,10,7,16,16,0.8889686876112561,0.6910200073218078,0.7043392293490403,0.7015658728963773,0.9992507907844089,5.349719323812468,2.67061149476498,32.07531772166557,0.08,30,49,23,4.335970858598519,Humana
0,30,20,8,4,21,2.727272727272727,1.8181818181818181,1,0,11,4,11,11,17,0.9709505941661296,1.6871277367170516,0.44,19,9,11,10,0.7369655941662062,2.259964162664737,1.0285189544531599,1.8136306675690912,1.7399079846287773,5.1637498307487,5.530895684452411,31.2185436803934,0.2,28,48,23,4.311074184082723,Aleatória
0,32,18,6,3,28,2.1333333333333333,1.2857142857142858,0,0,16,3,15,14,17,0.9426831889669534,2.5305335405799307,0.58,17,4,14,14,0.6438561897747247,1.2578641509408803,0.5890150893739515,1.0794810925861054,2.208817936257957,5.067882343122759,8.870674718867146,29.122923812442142,0.28,25,49,19,4.05869069550801,Aleatória
1,23,27,4,3,27,1.6428571428571428,1.9285714285714286,1,0,14,1,14,14,18,0.9953784385316868,2.3078994778802655,0.56,9,13,14,13,0.8889686876112561,0.9715336077668174,0.7985957062499249,0.9006800152084637,0.7272133408660715,4.633285464433156,2.302954788180847,24.834848565375886,-0.08,32,47,27,4.604764945046352,Humana
1,22,28,3,5,29,1.4666666666666666,1.8666666666666667,3,2,18,2,15,15,17,0.9895875209335165,2.749545416973504,0.6,7,13,14,15,0.8365012677171205,0.7180219742846006,1.3097921802925665,1.07496769977314,1.9797851867123653,5.4542926638879745,6.4127218934911205,33.13034349542284,-0.12,33,50,25,4.490740760310775,Aleatória
1,23,27,5,4,25,1.7692307692307692,2.076923076923077,1,0,13,1,13,13,17,0.9953784385316868,2.0614557962760203,0.52,10,14,13,12,0.8889686876112561,1.1200169060431568,1.1409536133993328,1.1409536133993328,1.0830101427023164,4.902766951227088,3.2152892561983477,28.035521982508364,-0.08,26,46,20,3.9887063270542344,Humana
1,24,26,4,7,20,2.1818181818181817,2.6,0,2,11,3,11,10,18,0.9988455357066628,1.7215109642404256,0.42,13,16,10,10,0.9434164716336324,1.3360853142453697,1.9595917942265426,1.675486865310398,1.0272431437298948,5.07495811140997,3.4056245285924196,29.638648434951463,-0.04,27,49,21,4.234774727466919,Aleatória
1,24,26,3,4,30,1.6,1.625,2,0,18,1,15,16,18,0.9988455357066628,2.777696887711113,0.62,9,10,15,15,0.9434164716336324,0.7118052168020874,0.9270248108869579,0.8299793761463617,1.162108243158318,5.300148660581332,3.398713958434114,31.69690624732731,-0.04,31,48,26,4.501397825434102,Aleatória
1,21,29,4,5,22,1.9090909090909092,2.4166666666666665,1,2,10,1,11,12,17,0.9814538947451146,1.663850954863446,0.46,10,17,11,11,0.7858751946471527,0.9958591954639383,1.4976833963009524,1.3072431633367745,0.84414390346099,4.3815401339152125,2.5410564648758727,23.16860528948066,-0.16,30,48,26,4.555533151426994,Humana
0,27,23,4,4,26,2.076923076923077,1.6428571428571428,1,0,15,0,13,14,18,0.9953784385316868,2.3341807984815572,0.54,14,9,13,13,0.8889686876112561,1.2064913185660093,1.0424656799518874,1.1451573950918745,1.0315032150626344,5.139049942453713,2.5005864743264303,30.323439962459037,0.08,32,49,27,4.615422010169679,Aleatória
1,17,33,5,8,19,1.7,3.3,0,2,9,3,10,10,17,0.924818704684491,1.414213562373095,0.4,7,23,10,9,0.5994620704162712,1.268857754044952,2.147091055358389,1.9364916731037085,1.3839460490447837,4.870551508812944,4.125333333333334,28.263200000000015,-0.32,28,48,21,4.102168956377574,Aleatória
-1,25,25,4,7,29,1.6666666666666667,1.6666666666666667,1,1,18,3,15,15,18,0.9999999997114609,2.7928480087537886,0.6,10,10,14,15,1.0,0.7888106377466153,1.5347819244295116,1.2202003478482082,2.9682752948323543,5.371963270486571,12.714413009578982,31.771282051282036,0.0,29,50,24,4.327484781955841,Aleatória
0,28,22,5,3,34,1.5555555555555556,1.2941176470588236,4,0,25,2,18,17,17,0.9895875209335165,3.618010503025109,0.7,10,5,17,17,0.8365012677171205,1.0122703976827,0.5703152773430975,0.8378787599208675,2.5574787730142754,6.15940654034943,10.230530016224982,40.883750097024695,0.12,27,49,21,4.118579554250694,Humana
0,28,22,5,3,34,1.5555555555555556,1.2941176470588236,3,0,25,2,18,17,16,0.9895875209335165,3.618010503025109,0.7,10,5,17,17,0.8365012677171205,1.0122703976827,0.5703152773430975,0.8378787599208675,2.5574787730142754,6.15940654034943,10.230530016224982,40.883750097024695,0.12,27,45,22,4.162057815120258,Humana
0,28,22,4,2,41,1.3333333333333333,1.0476190476190477,4,0,36,2,21,21,15,0.9895875209335165,5.072908435996061,0.84,7,1,20,21,0.8365012677171205,0.7126966450997982,0.21295885499998,0.5450249115361713,3.6148671657273486,6.665708468983728,17.404055707709333,46.162478002672,0.12,22,50,15,3.2681574786253944,Humana
0,26,24,6,5,28,1.7333333333333334,1.7142857142857142,3,2,20,1,15,14,18,0.9988455357066628,2.8572014279710847,0.58,11,10,14,14,0.9434164716336324,1.339983416149452,1.3850513878332367,1.3619598384918274,1.980879250501534,6.311678931766996,5.766637080867851,42.72887147816852,0.04,24,47,22,4.289760053836067,Humana
0,27,23,6,5,28,1.9285714285714286,1.5333333333333334,2,1,18,1,14,15,17,0.9953784385316868,2.683952309561406,0.58,13,8,14,14,0.8889686876112561,1.386891988496257,1.0873004286866728,1.2566115281578345,2.094158262973486,5.733420013551248,6.691902398751633,36.148133745887314,0.08,28,48,23,4.221946673862942,Humana
0,29,21,6,4,20,2.6363636363636362,2.1,2,0,10,2,11,10,17,0.9814538947451146,1.5632018423735305,0.42,18,11,10,10,0.7858751946471527,1.8719327529067273,1.044030650891055,1.557659736552012,0.7132446247960287,4.9392058021328475,2.2886103589833175,28.93666399954493,0.16,27,49,21,4.221946673862943,Aleatória
0,28,22,4,3,33,1.6470588235294117,1.2941176470588236,4,0,26,1,17,17,17,0.9895875209335165,3.6793477682872004,0.68,11,5,16,17,0.8365012677171205,1.081457430050014,0.6655122646461624,0.9150793638884732,1.6989688100935978,6.528646415637519,4.412027866948978,44.8690221858334,0.12,26,50,18,3.725104217943957,Humana
-1,25,25,3,3,28,1.6666666666666667,1.7857142857142858,0,0,13,0,15,14,18,0.9999999997114609,2.4420483205702546,0.58,10,11,14,14,1.0,0.7888106377466155,0.6738557951469003,0.7379632606562999,0.48726599156166095,4.290771847683855,1.963473236589691,20.228506522416364,0.0,30,49,24,4.414441303694973,Aleatória
1,23,27,6,7,24,1.7692307692307692,2.25,1,2,15,1,13,12,18,0.9953784385316868,2.1931712199461306,0.5,10,15,12,12,0.8889686876112561,1.4225570776082255,1.8314384146529925,1.6492422502470643,1.8190171877724972,5.8810405593621216,5.298442906574394,38.37909154956973,-0.08,29,49,27,4.604764945046352,Humana
0,37,13,3,1,25,2.8461538461538463,1.0,0,0,13,2,13,13,15,0.8267463722040789,2.368459414893994,0.52,24,0,13,12,0.4344028241457749,0.36080121229411,0.0,0.9576845844606717,0.1539071875380915,4.653613157509518,1.1080541103017691,23.089860133829752,0.48,16,46,6,2.2733041362437216,Humana
0,34,16,6,1,32,2.0,1.0,3,0,26,5,17,16,17,0.9043814574359548,3.6529987681355713,0.66,17,0,16,16,0.5563933485243853,1.5339299776947408,0.0,1.2090871117127275,2.5361536057521428,6.675899635831423,8.465491717380871,46.312557433239995,0.36,22,44,13,3.469138185100102,Humana
0,27,23,6,4,19,2.7,2.3,0,0,5,2,10,10,17,0.9953784385316868,1.3266499161421599,0.4,17,13,10,9,0.8889686876112561,1.4177446878757827,1.1,1.284523257866513,0.8492715754489343,3.2994934639589357,3.5123966942148765,12.434917355371898,0.08,29,45,25,4.484987227560983,Aleatória
1,17,33,4,6,21,1.5454545454545454,3.0,0,4,10,2,11,11,17,0.924818704684491,1.6632498309033434,0.44,6,22,11,10,0.5994620704162712,0.8907235428302467,1.8090680674665818,1.6006197146962735,1.0800435525440149,4.6038211807927025,2.7314464099895934,24.443675924696276,-0.32,33,47,25,4.368792054344756,Humana
0,27,23,6,5,25,2.076923076923077,1.7692307692307692,1,1,13,1,13,13,18,0.9953784385316868,2.1094074997496337,0.52,14,10,12,13,0.8889686876112561,1.3846153846153848,1.1200169060431568,1.2686478848054341,1.7267288157458038,4.798414862436959,5.652843858131487,26.437212057314497,0.08,33,50,31,4.838566847267296,Aleatória
1,21,29,5,4,29,1.4,1.9333333333333333,4,0,21,1,15,15,17,0.9814538947451146,2.9933259094191533,0.6,6,14,15,14,0.7858751946471527,1.0832051206181281,1.1234866364235145,1.1352924243950933,1.4984240084168297,6.356999539774091,4.004161712247324,43.182079081632615,-0.16,30,46,24,4.284006521086275,Aleatória
1,18,32,2,4,24,1.3846153846153846,2.6666666666666665,0,0,8,2,13,12,17,0.9426831889669534,1.9621416870348585,0.5,5,20,12,12,0.6438561897747247,0.48650425541051995,0.74535599249993,0.8944271909999159,0.6708203932499368,4.288978961708849,2.7499999999999996,20.883285545623206,-0.28,28,49,14,3.6372380444664265,Aleatória
0,28,22,6,5,9,5.6,4.4,0,3,0,1,5,5,17,0.9895875209335165,0.824621125123532,0.2,23,17,4,5,0.8365012677171205,0.4898979485566356,0.7999999999999999,0.8944271909999159,-0.838525491562421,4.750844890417583,3.1249999999999996,25.657439446366812,0.12,20,50,11,3.3422859467605486,Humana
0,29,21,5,4,23,2.4166666666666665,1.75,0,0,10,1,12,12,18,0.9814538947451146,1.780337046741431,0.48,17,9,11,12,0.7858751946471527,1.3202482931462383,1.0103629710818451,1.2219065248845982,1.0740617829986152,4.190212138618886,3.267777176852353,20.27066750484982,0.16,31,50,27,4.62117554291947,Aleatória
1,24,26,6,3,34,1.411764705882353,1.4444444444444444,5,0,27,3,17,18,17,0.9988455357066628,3.8223029707232787,0.7,7,8,17,17,0.9434164716336324,1.2394886768062046,0.6849348892187752,0.9938586931957764,3.0791223497958065,6.526699421356533,13.364012021036812,44.84309922460354,-0.04,26,48,21,3.755345427358,Humana
0,27,23,4,3,30,1.8,1.4375,2,0,18,1,15,16,18,0.9953784385316868,2.777696887711113,0.62,12,7,15,15,0.8889686876112561,0.9092121131323904,0.7043392293490403,0.8299793761463617,1.1621082431583183,5.300148660581332,3.398713958434116,31.69690624732731,0.08,31,49,26,4.550629619053459,Aleatória
1,24,26,4,5,28,1.6,1.8571428571428572,3,1,20,1,15,14,18,0.9988455357066628,2.8501929759228593,0.58,9,12,14,14,0.9434164716336324,1.0198039027185568,1.3552618543578767,1.200475530036497,1.3791905728559937,6.345811421014633,3.471767473777082,43.12879056394449,-0.04,28,49,21,4.2724994555866935,Humana
-1,25,25,4,7,37,1.3157894736842106,1.3157894736842106,6,1,35,3,19,19,17,0.9999999997114609,4.9012651427973175,0.76,6,6,18,19,1.0,0.9206766149755737,1.3397812696166167,1.1494910351495555,3.8331372467945477,6.815601474614814,17.30544677821289,47.63629037036231,0.0,18,50,13,2.7417879262652947,Humana
0,26,24,3,5,28,1.8571428571428572,1.6,0,1,15,2,14,15,18,0.9988455357066628,2.4745908752761534,0.58,12,9,14,14,0.9434164716336324,0.7423074889580902,1.083205120618128,0.9430892642191271,1.5603085413193867,4.786371479760106,5.6639666561811906,25.81752240638203,0.04,30,48,22,4.246843348378739,Humana
0,30,20,3,3,36,1.5789473684210527,1.1111111111111112,3,0,27,0,19,18,17,0.9709505941661296,3.897742936623707,0.74,11,2,18,18,0.7369655941662062,0.6740130776245103,0.4581228472908512,0.6245524328806131,1.5734316351820385,6.196420149108264,4.23012666750831,41.342137492401264,0.2,26,49,15,3.5578579476315735,Aleatória
0,26,24,7,4,25,2.0,1.8461538461538463,2,0,13,3,13,13,18,0.9988455357066628,2.137662274541982,0.52,13,11,12,13,0.9434164716336324,1.7097008285302207,0.8634593969478327,1.356553237580646,2.173197697536298,4.83717761406247,8.10579915426846,26.24515394393053,0.04,31,50,25,4.495644292684311,Aleatória
1,22,28,5,11,16,2.75,3.111111111111111,0,2,5,6,8,9,17,0.9895875209335165,1.124455423749648,0.34,14,19,8,8,0.8365012677171205,1.5612494995995996,2.9228769862146455,2.387974485904052,2.1430911800073367,3.524506901658896,7.807024106890374,14.058031183393062,-0.12,28,49,21,4.107012837388965,Aleatória
0,32,18,5,2,32,1.8823529411764706,1.125,2,0,23,3,17,16,17,0.9426831889669534,3.3142721674599995,0.66,15,2,16,16,0.6438561897747247,1.1823383083671637,0.33071891388307384,0.9573072120564433,2.132900737149922,6.2030376513861265,7.118037678563542,41.42342237748664,0.28,26,45,19,4.05869069550801,Humana
0,35,15,7,2,20,3.5,1.3636363636363635,0,0,8,5,10,11,17,0.8812908989421536,1.4572576985557497,0.42,25,4,10,10,0.5145731728297583,1.746424919657298,0.4810456929208347,1.6468206157895793,1.4260588606645788,4.055465780908084,4.3388189170143505,19.171432873542223,0.4,27,49,17,3.9011882499028676,Aleatória
1,24,26,3,4,34,1.411764705882353,1.4444444444444444,3,0,25,1,17,18,17,0.9988455357066628,3.5958309192730407,0.7,7,8,17,17,0.9434164716336324,0.6910200073218078,0.8314794192830981,0.766651877999928,1.7624563572654584,6.2348564386050755,5.251736111111108,41.81077657132911,-0.04,29,46,20,4.05869069550801,Humana
0,28,22,7,3,24,2.1538461538461537,1.8333333333333333,1,0,7,4,13,12,18,0.9895875209335165,2.3086792761230392,0.5,15,10,12,12,0.8365012677171205,1.5112986695683464,0.5527707983925666,1.1661903789690602,3.0264456201619203,5.397691481194001,13.71107266435986,32.38289761307196,0.12,26,49,22,3.8914444251956244,Humana
0,26,24,6,5,25,2.0,1.8461538461538463,1,1,14,1,13,13,17,0.9988455357066628,2.183941391154992,0.52,13,11,13,12,0.9434164716336324,1.4675987714106855,1.2307692307692306,1.356553237580646,1.618548197082785,5.220436402148389,4.709060080023984,30.585879529314628,0.04,29,43,27,4.621175542919471,Aleatória
1,24,26,5,6,16,2.6666666666666665,3.25,0,2,1,1,9,8,17,0.9988455357066628,1.226539848516957,0.34,15,18,8,8,0.9434164716336324,1.1547005383792517,1.3919410907075054,1.3047690007540491,0.9033190303406041,4.338922386876033,2.931290898274835,21.630577568053333,-0.04,27,48,19,4.110093477608016,Aleatória
1,22,28,3,8,36,1.1578947368421053,1.5555555555555556,5,1,31,5,19,18,16,0.9895875209335165,4.362613895361358,0.74,3,10,18,18,0.8365012677171205,0.4880851839734581,1.6063146994223287,1.1904170565159589,4.776441214437105,6.678021018357881,26.41407588479117,46.30034477005317,-0.12,24,49,19,3.6701188915748086,Humana
1,21,29,4,5,31,1.3125,1.8125,3,1,23,1,16,16,17,0.9814538947451146,3.2665578213158875,0.64,5,13,15,16,0.7858751946471527,0.7680128579652817,1.2358574958303243,1.0588171466310885,1.8893116214018728,6.432580964494963,5.500285301509063,43.93414659794849,-0.16,30,50,24,4.3794491194680845,Aleatória
-1,25,25,8,7,17,2.7777777777777777,2.7777777777777777,0,2,7,1,9,9,17,0.9999999997114609,1.179152237838694,0.36,16,16,8,9,1.0,2.199887763691481,2.042752923427804,2.1227747971714224,1.1631483386655408,4.25235779934618,3.2392343779320694,22.089020751866148,0.0,33,50,28,4.586183358692582,Aleatória
1,22,28,4,6,23,1.8333333333333333,2.3333333333333335,0,1,8,2,12,12,17,0.9895875209335165,1.9103926298015288,0.48,10,16,11,12,0.8365012677171205,0.7993052538854533,1.4337208778404378,1.1873172373979173,1.6312250409502893,4.565865266043022,5.760416413890169,23.212477856359072,-0.12,29,50,24,4.40868777094518,Aleatória
1,21,29,6,8,22,1.9090909090909092,2.4166666666666665,1,1,11,2,11,12,17,0.9814538947451146,1.78,0.46,10,17,11,11,0.7858751946471527,1.443137078762504,1.9346977943739836,1.7358665024067068,2.025884912569215,4.799904676659538,6.703331501915119,26.551422940089097,-0.16,28,47,27,4.62117554291947,Aleatória
0,29,21,4,4,28,1.9333333333333333,1.5,2,0,18,0,15,14,18,0.9814538947451146,2.6388633916896884,0.58,14,7,14,14,0.7858751946471527,1.1234866364235143,0.9063269671749657,1.0470501000475156,1.1090859992515867,5.846119266363157,2.7558288357385856,38.10914185140586,0.16,31,46,27,4.5241235114692495,Humana
0,26,24,2,4,38,1.3,1.263157894736842,4,0,30,2,20,19,17,0.9988455357066628,4.323378308684077,0.78,6,5,19,19,0.9434164716336324,0.45825756949558394,0.713929471907923,0.5969459859909135,2.6959376693744552,6.262117697523025,11.486996364428592,41.88746455032644,0.04,26,49,17,3.65370829370169,Humana
1,20,30,4,10,22,1.6666666666666667,2.727272727272727,2,2,13,6,12,11,17,0.9709505941661296,1.9617339269126177,0.46,8,19,11,11,0.7369655941662062,1.1055415967851332,2.5616368733827946,2.014127795113125,2.5712047514616794,5.448264290661597,10.09463715410626,33.82042390705005,-0.2,31,48,24,4.381620107948735,Aleatória
1,23,27,6,8,19,2.3,2.7,0,2,5,2,10,10,17,0.9953784385316868,1.574801574802362,0.4,13,17,10,9,0.8889686876112561,1.3453624047073711,2.1,1.7748239349298849,1.851290272262465,5.0390372971043345,5.6953892668178385,29.101456815816885,-0.08,28,43,23,4.325313793475192,Aleatória
0,26,24,5,5,19,2.6,2.4,0,2,6,0,10,10,17,0.9988455357066628,1.3266499161421597,0.4,16,14,10,9,0.9434164716336324,1.2000000000000002,1.4966629547095767,1.3601470508735443,0.596119963859844,3.2994934639589375,2.2388604821037252,12.434917355371905,0.04,27,48,23,4.352381456471638,Humana
-1,25,25,4,4,30,1.6666666666666667,1.5625,5,0,23,0,15,16,18,0.9999999997114609,3.273469107842627,0.62,10,9,15,15,1.0,1.1352924243950933,1.0588171466310885,1.0977225501402297,1.3944053824250793,6.414729469619203,3.2047437515101036,43.725072328067014,0.0,25,48,15,3.655819630820195,Humana
0,26,24,5,4,24,2.0,2.0,3,0,15,1,13,12,18,0.9988455357066628,2.2203603311174516,0.5,13,12,12,12,0.9434164716336324,1.4142135623730951,1.2909944487358056,1.3564659966250536,0.865420177430918,5.73888540997076,2.103024574669187,36.72356191549853,0.04,26,45,23,4.359455977325824,Humana
-1,25,25,5,4,27,1.7857142857142858,1.7857142857142858,2,0,17,1,14,14,18,0.9999999997114609,2.49927989629013,0.56,11,11,13,14,1.0,1.263700429496724,1.0809104250301114,1.175862688082452,1.3435777472137773,5.816892719525646,3.5439196089377862,37.665472492483524,0.0,29,50,26,4.5342190211803395,Aleatória
-1,25,25,6,4,29,1.6666666666666667,1.6666666666666667,3,0,19,2,15,15,18,0.9999999997114609,2.792848008753788,0.6,10,10,14,15,1.0,1.2995725793078614,0.9428090415820634,1.1352924243950933,2.181826850093425,5.867735106360025,7.936979785969085,37.9724654832347,0.0,29,50,29,4.673139880431712,Aleatória
0,29,21,7,4,26,2.0714285714285716,1.6153846153846154,2,0,15,3,14,13,17,0.9814538947451146,2.3169807940507408,0.54,15,8,13,13,0.7858751946471527,1.6241167144145818,0.9230769230769231,1.3527394346481239,2.2450191837895863,5.2937119017545715,8.366225058385353,31.557408946466847,0.16,30,49,28,4.675310868912363,Humana
1,23,27,5,8,26,1.7692307692307692,1.9285714285714286,3,1,16,3,13,14,18,0.9953784385316868,2.4017493624439665,0.54,10,13,13,13,0.8889686876112561,1.1200169060431568,1.8308579454251854,1.5324563604131258,2.6579324282204944,5.580794506713269,10.346600958599005,34.895142775325645,-0.08,31,49,24,4.381620107948733,Aleatória
0,27,23,3,2,38,1.35,1.2105263157894737,3,0,29,1,20,19,17,0.9953784385316868,4.225115383039852,0.78,7,4,19,19,0.8889686876112561,0.5722761571129799,0.40768245749551757,0.5037662231894486,1.5543870528023014,6.100527389522975,4.492912561411044,40.089511308225056,0.08,27,49,14,3.6195661098510588,Humana
1,19,31,3,10,24,1.5833333333333333,2.3846153846153846,1,3,16,7,12,13,17,0.9580420219377606,2.3,0.5,7,18,12,12,0.6896598793878495,0.759202798262025,2.558198330510137,1.9595917942265424,2.8386013946315476,6.1642146790498895,11.42578125,41.30997602209826,-0.24,28,47,19,4.003645717776717,Aleatória
1,21,29,4,6,29,1.4,1.9333333333333333,4,1,20,2,15,15,17,0.9814538947451146,2.8844410203711917,0.6,6,14,15,14,0.7858751946471527,0.8,1.4360439485692011,1.1925695879998877,2.078844447831836,6.152371887940398,6.958007812500003,41.03735207100588,-0.16,29,47,26,4.544876086303668,Aleatória
0,28,22,9,3,25,2.1538461538461537,1.6923076923076923,2,0,14,6,13,13,18,0.9895875209335165,2.2021807373601288,0.52,15,9,13,12,0.8365012677171205,2.1784311166932766,0.7216024245882199,1.6390212117432705,3.110868875899362,5.113817613740389,13.542839954200542,29.61320582508186,0.12,30,45,25,4.455748576083888,Aleatória
1,21,29,5,8,22,1.75,2.6363636363636362,1,1,11,3,12,11,17,0.9814538947451146,1.7573844200970945,0.46,9,18,11,11,0.7858751946471527,1.1636866703140785,1.966664332071267,1.6590246981164272,2.0076526560433163,4.808962310328278,7.173076923076922,27.10244718168719,-0.16,32,48,25,4.501397825434102,Aleatória
0,27,23,2,3,32,1.588235294117647,1.4375,0,0,17,1,17,16,17,0.9953784385316868,3.1407642382070007,0.66,10,7,16,16,0.8889686876112561,0.49215295678475035,0.6091746465505602,0.5571144336621283,0.46604033643974546,4.711191898953035,2.1664682609152335,23.34514413237587,0.08,22,49,10,3.106874611471191,Humana
1,20,30,5,6,25,1.5384615384615385,2.3076923076923075,2,1,16,1,13,13,18,0.9709505941661296,2.308592644881292,0.52,7,17,12,13,0.7369655941662062,1.1512791959304436,1.5384615384615385,1.4121199808219862,1.4475072208735789,6.074932800606009,4.050533156054908,40.4909284893301,-0.2,31,50,26,4.528465488430548,Aleatória
1,24,26,2,3,35,1.3333333333333333,1.4444444444444444,5,0,24,1,18,18,18,0.9988455357066628,3.6168494577463415,0.72,6,8,17,18,0.9434164716336324,0.4714045207910317,0.6849348892187752,0.5905636562630361,1.2454145301786388,5.664485955065441,3.521105803116925,35.19589385763684,-0.04,29,50,19,4.120750542731344,Aleatória
1,24,26,4,7,26,1.7142857142857142,2.0,2,1,14,3,14,13,18,0.9988455357066628,2.264597094407745,0.54,10,13,13,13,0.9434164716336324,0.8806305718527108,1.6172150801252798,1.2968252888897478,2.416026419370415,4.928165321691248,9.642151162017091,27.346100182566378,-0.04,31,49,28,4.648243205915917,Aleatória
1,24,26,1,2,46,1.0,1.1304347826086956,6,0,44,1,24,23,15,0.9988455357066628,6.165744075129942,0.94,0,3,23,23,0.9434164716336324,0.0,0.33678116053977536,0.2444494743207672,3.5685919470918046,6.809672786168891,13.73484848484848,47.57635099245687,-0.04,20,49,6,2.0870793466088498,Humana
0,30,20,5,2,27,2.142857142857143,1.4285714285714286,0,0,12,3,14,14,17,0.9709505941661296,2.3762154784446636,0.56,16,6,14,13,0.7369655941662062,1.0594569267279519,0.4948716593053935,0.9006800152084639,1.6070517038892191,4.47329133457634,6.3964637474783395,21.514324536502404,0.2,27,48,21,4.14347622876649,Aleatória
0,35,15,6,4,22,2.9166666666666665,1.3636363636363635,1,0,12,2,12,11,17,0.8812908989421536,1.835320135562186,0.46,23,4,11,11,0.5145731728297583,1.6051133570215186,0.8813963377120598,1.5223601217401388,1.0359790088343046,5.246487789556534,2.799348802056584,31.818779471664506,0.4,28,45,22,4.14130524028584,Humana
1,21,29,4,6,22,1.9090909090909092,2.4166666666666665,0,2,12,2,11,12,18,0.9814538947451146,1.824390309116994,0.46,10,17,11,11,0.7858751946471527,0.9958591954639383,1.9346977943739834,1.5784465096235953,1.238018892003622,5.271391117761123,3.4017525519191514,32.39971762462738,-0.16,28,46,23,4.354552444952288,Aleatória
1,21,29,3,6,25,1.6153846153846154,2.230769230769231,1,2,12,3,13,13,18,0.9814538947451146,2.1094074997496333,0.52,8,16,13,12,0.7858751946471527,0.6249260311258431,1.5764539639937842,1.2379597645716216,1.8489948982900564,4.542715417997652,6.200638034614868,22.810351254680512,-0.16,31,47,25,4.528465488430548,Aleatória
1,24,26,3,4,32,1.5,1.5294117647058822,3,0,22,1,16,17,17,0.9988455357066628,3.210046728631844,0.66,8,9,16,16,0.9434164716336324,0.7071067811865476,0.9150793638884732,0.820982859645095,1.4300623075480878,5.982591210754329,3.965479734796456,39.240946958082624,-0.04,30,47,23,4.2924925977289545,Aleatória
0,28,22,5,5,28,1.8666666666666667,1.5714285714285714,1,1,18,0,15,14,18,0.9895875209335165,2.7062150690586297,0.58,13,8,14,14,0.8365012677171205,1.3097921802925665,1.1157499537009508,1.2288641159452043,1.874011300689594,5.606766082646025,5.33960815921632,34.986075457231536,0.12,26,49,23,4.346627923721846,Humana
1,24,26,6,5,23,2.0,2.1666666666666665,0,1,14,1,12,12,18,0.9988455357066628,2.041959842896035,0.48,12,14,11,12,0.9434164716336324,1.5275252316519468,1.4624940645653537,1.4976833963009524,1.122821119008859,5.877879781057572,3.0606734465009717,38.53864627882167,-0.04,28,50,24,4.441508966691418,Aleatória
1,22,28,2,6,31,1.375,1.75,2,1,21,4,16,16,15,0.9895875209335165,3.122563049803799,0.64,6,12,15,16,0.8365012677171205,0.4841229182759271,1.3919410907075054,1.0588171466310885,2.6790957087285867,5.79832173645218,10.684371547548228,36.767893796875946,-0.12,27,50,21,4.153571738477581,Humana
0,26,24,3,3,42,1.2380952380952381,1.0909090909090908,6,0,38,0,21,22,15,0.9988455357066628,5.3292025669887995,0.86,5,2,21,21,0.9434164716336324,0.5259695722470125,0.41659779045053097,0.4788665181854419,2.9647126487329505,6.7672339971985975,10.74078853684585,47.18019378343631,0.04,20,49,13,2.9455797511885184,Humana
0,26,24,4,4,28,1.7333333333333334,1.7142857142857142,0,0,15,0,15,14,18,0.9988455357066628,2.458373446000424,0.58,11,10,14,14,0.9434164716336324,0.8537498983243799,0.9583148474999098,0.9057879680388757,1.127514817329199,4.8507073279494985,3.369766855702583,26.45162564172142,0.04,29,47,26,4.447824054853445,Aleatória
0,30,20,9,5,22,2.727272727272727,1.6666666666666667,0,1,10,4,11,12,17,0.9709505941661296,1.7687283567580412,0.46,19,8,11,11,0.7369655941662062,2.0928844424038795,1.178511301977579,1.7607353679405728,2.6020049856129415,4.294998616816421,10.204544913741824,20.990836979722776,0.2,32,49,26,4.4314134569803265,Aleatória
0,49,1,49,1,1,49.0,1.0,0,0,1,48,1,1,10,0.14144054225328165,0.19595917942265426,0.04,48,0,1,0,0.029146345659516508,0.0,0.0,24.0,0.0,4.694855340334423,1.0,23.04166666666666,0.96,13,0,2,0.15109697051711368,Humana
1,22,28,3,4,31,1.375,1.75,2,0,19,1,16,16,17,0.9895875209335165,2.9377542443165665,0.64,6,12,16,15,0.8365012677171205,0.5994789404140899,0.9013878188659973,0.7880950133074057,1.325742839521275,5.343832090917059,4.078201020529251,31.83315103544784,-0.12,28,48,24,4.441508966691418,Humana
0,29,21,6,6,22,2.6363636363636362,1.75,0,1,12,0,11,12,18,0.9814538947451146,1.8353201355621858,0.46,18,9,11,11,0.7858751946471527,1.7200807207658637,1.4215601757693317,1.632607248305964,1.2778434423831457,5.285309597226322,3.2918032292138237,32.03368997053735,0.16,28,49,25,4.4743301624376555,Aleatória
0,26,24,6,4,25,2.0,1.8461538461538463,1,0,13,2,13,13,18,0.9988455357066628,2.090358820872627,0.52,13,11,13,12,0.9434164716336324,1.4142135623730951,0.9483713850721502,1.2064913185660093,1.5931642500814385,4.799941193802059,5.646044021415821,26.780168860155758,0.04,30,47,25,4.501397825434102,Aleatória
1,24,26,24,25,2,24.0,13.0,0,5,1,1,1,2,14,0.9988455357066628,0.23748684174075835,0.06,23,24,1,1,0.9434164716336324,0.0,12.0,11.08552609887726,-0.7027936955484729,3.7054684526926827,1.5000000000000002,14.730496453900704,-0.04,15,49,7,1.6392743957069866,Humana
0,27,23,14,7,17,3.0,2.5555555555555554,0,2,9,7,9,9,18,0.9953784385316868,1.396567220007687,0.36,18,14,9,8,0.8889686876112561,3.9440531887330774,2.2166597048066667,3.206859931035958,2.4756436059916824,5.112923549329912,8.603063314161199,30.26550966007858,0.08,26,40,25,4.201194099028524,Aleatória
1,24,26,5,5,37,1.263157894736842,1.368421052631579,6,1,34,0,19,19,17,0.9988455357066628,4.760504174979791,0.76,5,7,18,19,0.9434164716336324,0.90856192113853,1.086303549502647,1.0027662570135607,3.095395582973078,6.805158234189749,10.955740728092339,47.541026803377406,-0.04,24,50,20,3.3450525501511765,Humana
0,26,24,5,6,34,1.4444444444444444,1.411764705882353,5,1,29,1,18,17,17,0.9988455357066628,4.065710270051224,0.7,8,7,17,17,0.9434164716336324,1.0122703976826999,1.2394886768062046,1.1284810090360857,2.921363558895191,6.741700353043371,10.79635108481262,46.95060841916421,0.04,27,49,20,3.886948640510398,Humana
0,29,21,5,2,30,1.9333333333333333,1.3125,2,0,20,3,15,16,18,0.9814538947451146,2.9522195040342107,0.62,14,5,15,15,0.7858751946471527,1.339983416149452,0.46351240544347894,1.0372861413428083,1.8651894181831121,5.85342104717921,5.663018306028307,37.579685226185845,0.16,28,49,21,4.294663586209604,Aleatória
0,26,24,5,5,25,2.0,1.8461538461538463,1,1,12,0,13,13,18,0.9988455357066628,2.09990475974507,0.52,13,11,12,13,0.9434164716336324,1.2403473458920846,1.0986812966989,1.1741798094210576,1.43227053987882,4.585486835373792,4.234541067251191,23.19696621805231,0.04,31,50,31,4.805745651521058,Aleatória
0,29,21,4,4,27,2.0714285714285716,1.5,1,0,15,0,14,14,18,0.9814538947451146,2.350829640786418,0.56,15,7,13,14,0.7858751946471527,1.099628879881475,0.823754471047914,1.0126747770541304,1.0569656691373621,5.078658933855018,2.86530036385238,29.647524131366367,0.16,31,50,24,4.425098368818299,Aleatória
1,24,26,4,3,42,1.1428571428571428,1.1818181818181819,7,0,39,1,21,22,16,0.9988455357066628,5.458974262624803,0.86,3,4,21,21,0.9434164716336324,0.63887656499994,0.4895604370122276,0.5677467728248234,3.8180880966874797,6.817442375822744,17.279784694383135,47.65561456921281,-0.04,21,49,14,2.799584371082959,Humana
1,22,28,5,11,17,2.4444444444444446,3.111111111111111,0,2,5,6,9,9,18,0.9895875209335165,1.179152237838694,0.36,13,19,8,9,0.8365012677171205,1.3425606637327303,2.922876986214646,2.2986845406196887,2.468114396215412,3.6668110229772872,9.255415320115294,15.851940182292255,-0.12,29,50,26,4.438428326472367,Aleatória
1,22,28,4,5,25,1.6923076923076923,2.1538461538461537,3,1,14,1,13,13,18,0.9895875209335165,2.1282856951076847,0.52,9,15,13,12,0.8365012677171205,0.9910845174403942,1.3499945211372495,1.2064913185660093,1.067552228092638,5.318642265375953,2.898076541741025,32.65588308579844,-0.12,28,43,23,4.3195602607254004,Humana
1,17,33,3,8,22,1.5454545454545454,2.75,1,3,12,5,11,12,18,0.924818704684491,1.8677258899528058,0.46,6,21,11,11,0.5994620704162712,0.6555547773570889,2.3139072294858036,1.83331901237461,1.8595804992123548,5.228965643374303,5.636935498360794,30.699482726119598,-0.32,29,49,22,4.177558761254977,Humana
0,31,19,7,5,16,3.4444444444444446,2.375,0,2,4,2,9,8,18,0.9580420219377606,1.142103322821539,0.34,22,11,8,8,0.6896598793878495,1.4989708403591158,1.653594569415369,1.6616996343324157,0.7857117836823063,3.577898133358853,2.966033504814669,15.359063245565858,0.24,26,47,19,4.093682879734898,Humana
-1,25,25,5,6,22,2.0833333333333335,2.272727272727273,1,1,10,1,12,11,18,0.9999999997114609,1.6877203559831826,0.46,13,14,11,11,1.0,1.25554326444328,1.4826824027545535,1.372150768526913,1.1996858176344412,4.374983952295317,3.808632118836796,22.518382557323882,0.0,33,48,26,4.53421902118034,Aleatória
0,27,23,5,5,28,1.8,1.6428571428571428,3,1,20,0,15,14,17,0.9953784385316868,2.864192730945319,0.58,12,9,14,14,0.8889686876112561,1.3759844960366863,1.2309777099724346,1.3103448275862069,1.7137702288963415,6.272824583745734,4.450330338164995,42.320988421825746,0.08,30,49,28,4.613251021689029,Aleatória
1,23,27,3,7,29,1.5333333333333334,1.8,3,1,19,4,15,15,17,0.9953784385316868,2.814249455894058,0.6,8,12,14,15,0.8889686876112561,0.7180219742846006,1.5577761927397231,1.2202003478482082,2.858188161644891,5.757496112896202,12.413677879260424,36.86256504438322,-0.08,31,50,22,4.27334945596295,Aleatória
0,31,19,6,4,20,2.8181818181818183,1.9,1,0,8,2,11,10,18,0.9580420219377606,1.4154857823376399,0.42,20,9,10,10,0.6896598793878495,1.6958871005616027,0.9433981132056604,1.4630753805464016,0.8737413617786122,3.9707717607503716,2.7939843076702107,19.088509797955606,0.24,28,47,24,4.34389537982896,Aleatória
-1,25,25,4,4,27,1.7857142857142858,1.7857142857142858,1,0,14,0,14,14,18,0.9999999997114609,2.2992172581119865,0.56,11,11,14,13,1.0,0.9394961741404219,0.9394961741404219,0.9394961741404219,0.954532382079653,4.730992103558808,2.8481071870092545,25.65042885870232,0.0,33,46,28,4.691721466785481,Aleatória
1,23,27,4,5,24,1.9166666666666667,2.076923076923077,0,1,10,1,12,13,18,0.9953784385316868,1.8894443627691184,0.5,11,14,12,12,0.8889686876112561,0.9537935951882998,1.1409536133993328,1.0583005244258363,1.0124048384175728,4.047252713132071,3.571428571428571,18.39500506084787,-0.08,31,49,27,4.577697282049905,Humana
1,23,27,4,4,24,1.9166666666666667,2.076923076923077,0,0,9,0,12,13,17,0.9953784385316868,1.9313207915827966,0.5,11,14,12,12,0.8889686876112561,0.9537935951882998,0.9970370305242862,0.9797958971132712,0.7654655446197433,4.156124495970569,2.6041666666666665,19.329004017853933,-0.08,31,49,24,4.414441303694972,Aleatória
-1,25,25,4,6,24,2.0833333333333335,1.9230769230769231,0,1,14,2,12,13,17,0.9999999997114609,2.090454496036687,0.5,13,12,12,12,1.0,1.0374916331657276,1.5913969896597846,1.3564659966250536,1.2500513674002147,5.536772377167793,3.8043478260869565,35.02780556006472,0.0,30,49,23,4.292492597728954,Aleatória
0,26,24,3,3,28,1.8571428571428572,1.6,1,0,13,0,14,15,18,0.9988455357066628,2.4420483205702546,0.58,12,9,14,14,0.9434164716336324,0.8329931278350429,0.6110100926607788,0.7379632606562999,0.48726599156166095,4.290771847683855,1.963473236589691,20.228506522416364,0.04,32,49,24,4.3873736406985255,Humana
0,26,24,8,5,26,1.8571428571428572,1.8461538461538463,3,1,18,3,14,13,18,0.9988455357066628,2.5706808436676853,0.54,12,11,13,13,0.9434164716336324,1.8070158058105028,1.3499945211372493,1.6033230238454341,2.3987198503028324,6.293641314167839,8.76031443023615,42.596561889904514,0.04,29,42,24,4.385202652217877,Aleatória
1,22,28,3,5,27,1.5714285714285714,2.0,2,1,15,2,14,14,17,0.9895875209335165,2.3762154784446636,0.56,8,14,14,13,0.8365012677171205,0.7284313590846836,1.3093073414159542,1.0809104250301111,1.4509152502568516,5.099359793186543,4.314353273202265,29.204723024808153,-0.12,30,46,23,4.398030705821853,Aleatória
1,22,28,3,6,31,1.375,1.75,3,1,20,3,16,16,18,0.9895875209335165,3.051294807126968,0.64,6,12,15,16,0.8365012677171205,0.5994789404140899,1.25,0.998044963916957,2.8452684849068794,5.5131517304150615,12.554878892733564,33.54222360802817,-0.12,28,50,23,4.325313793475192,Aleatória
0,28,22,9,3,32,1.6470588235294117,1.375,3,0,24,6,17,16,18,0.9895875209335165,3.479137824231745,0.66,11,6,16,16,0.8365012677171205,1.8768301333580961,0.5994789404140899,1.4168084518255708,4.476304885399853,6.153125061813565,23.65552266816445,40.73030769904684,0.12,26,49,23,4.238918827148298,Aleatória
-1,25,25,8,4,31,1.5625,1.5625,4,0,26,4,16,16,18,0.9999999997114609,3.648342089223541,0.64,9,9,15,16,1.0,1.7309228030157786,1.0588171466310885,1.4347800354061246,3.143808467485155,6.7144953668606835,13.267253329684692,46.69387591879821,0.0,25,50,18,3.539365678798667,Humana
1,24,26,4,3,31,1.5,1.625,4,0,20,1,16,16,18,0.9988455357066628,2.985029313088902,0.64,8,10,16,15,0.9434164716336324,0.8660254037844386,0.7806247497997998,0.8267972847076845,1.2932864367881443,5.669260561734397,3.6539102040816327,35.834293589868054,-0.04,31,48,24,4.398030705821853,Humana
0,27,23,6,5,21,2.4545454545454546,2.090909090909091,0,1,11,1,11,11,18,0.9953784385316868,1.6871277367170516,0.44,16,12,11,10,0.8889686876112561,1.724878723728207,1.443137078762504,1.6006197146962735,0.9470305552332505,5.163749830748699,2.489698231009365,31.2185436803934,0.08,29,42,25,4.51205489055743,Aleatória
-1,25,25,10,7,22,2.0833333333333335,2.272727272727273,2,1,12,3,12,11,18,0.9999999997114609,1.9309065228539677,0.46,13,14,11,11,1.0,2.43099202430247,1.7627926754241194,2.139731269454658,2.5693675439654173,5.036325271686366,8.9770882926327,28.151128817620855,0.0,32,48,27,4.544876086303667,Aleatória
0,28,22,5,3,25,2.1538461538461537,1.6923076923076923,1,0,11,2,13,13,18,0.9895875209335165,2.09990475974507,0.52,15,9,12,13,0.8365012677171205,1.4058205294228512,0.6056929133855239,1.1067303515337046,1.5139959629361508,4.352218947362348,4.903941748932296,20.761983354433458,0.12,29,50,24,4.4472624994412095,Aleatória
1,22,28,3,7,26,1.6923076923076923,2.0,2,1,15,4,13,14,18,0.9895875209335165,2.299652147608416,0.54,9,14,13,13,0.8365012677171205,0.9101661204768638,1.6035674514745464,1.3250773199998753,2.2789113893343065,5.296668315789302,8.87294677734375,32.00556689770955,-0.12,28,48,25,4.484987227560983,Aleatória
0,27,23,5,4,25,2.076923076923077,1.7692307692307692,2,0,17,1,13,13,18,0.9953784385316868,2.475802900071005,0.52,14,10,13,12,0.8889686876112561,1.4390989949130544,1.249852062251686,1.356553237580646,0.9714571132203538,6.01338505047921,2.245375874939258,39.48278939460001,0.08,23,47,16,3.8160546203182237,Humana
1,24,26,2,2,44,1.0909090909090908,1.1304347826086956,6,0,40,0,22,23,14,0.9988455357066628,5.629387178015027,0.9,2,3,22,22,0.9434164716336324,0.28747978728803447,0.33678116053977536,0.3142696805273545,2.4748737341529154,6.70537921297068,7.124999999999998,46.55334600407207,-0.04,22,48,10,2.4800836951874476,Humana
0,27,23,2,2,41,1.2857142857142858,1.0952380952380953,5,0,34,0,21,21,15,0.9953784385316868,4.8676893902548874,0.84,6,2,20,21,0.8889686876112561,0.45175395145262565,0.29354352395090366,0.392676726249301,1.5764815627361644,6.381452082969372,3.485294117647059,43.16663608769501,0.08,22,50,12,2.939507788271281,Humana
0,27,23,7,4,24,2.076923076923077,1.9166666666666667,1,0,12,3,13,12,18,0.9953784385316868,2.0322401432901573,0.5,14,11,12,12,0.8889686876112561,1.6853001769389728,1.0374916331657276,1.4142135623730951,1.951614716074871,4.653794065563705,6.86,24.267158745141266,0.08,30,49,28,4.6917214667854825,Aleatória
1,21,29,7,7,27,1.5,2.0714285714285716,3,1,19,0,14,14,17,0.9814538947451146,2.74342851191716,0.56,7,15,14,13,0.7858751946471527,1.546886273407694,1.624116714414582,1.6115020246683538,2.4494139103145365,6.153582348500384,8.006611831820937,40.962768063220174,-0.16,27,48,22,4.221946673862942,Aleatória
1,22,28,4,6,27,1.5714285714285714,2.0,3,1,18,2,14,14,18,0.9895875209335165,2.6012304780622575,0.56,8,14,13,14,0.8365012677171205,0.9035079029052514,1.558387444947959,1.291652951430366,1.6955323146627377,6.084713337173414,5.1164885110680896,40.49157460386936,-0.12,29,50,22,4.25693885808983,Humana
1,24,26,4,4,24,2.0,2.0,0,0,11,0,12,13,17,0.9988455357066628,1.91049731745428,0.5,12,13,12,12,0.9434164716336324,1.1547005383792515,1.0377490433255416,1.0954451150103321,0.7302967433402215,4.2590932879258485,2.166666666666667,21.215425032839182,-0.04,30,47,26,4.588354347173232,Aleatória
-1,25,25,3,4,36,1.3157894736842106,1.3888888888888888,5,0,30,1,19,18,17,0.9999999997114609,4.227576137694033,0.74,6,7,18,18,1.0,0.653140718210045,0.8906233078822998,0.778641096804753,2.0467489399234657,6.635765062172383,5.851104659602272,45.902687542197306,0.0,26,48,17,3.707282064282346,Humana
1,23,27,3,6,25,1.7692307692307692,2.076923076923077,1,1,13,3,13,13,17,0.9953784385316868,2.1469979040511427,0.52,10,14,12,13,0.8889686876112561,0.8904489925223251,1.3846153846153846,1.1741798094210576,1.5748227903143437,4.646795817924876,5.971578036066232,24.874911101122038,-0.08,29,50,23,4.381620107948733,Aleatória
1,22,28,3,3,31,1.375,1.75,3,0,17,0,16,16,18,0.9895875209335165,2.9035151110335216,0.64,6,12,16,15,0.8365012677171205,0.5994789404140899,0.6614378277661477,0.6584783595532961,0.7541958128411748,4.776226525690297,2.4852690528366206,24.856330374783308,-0.12,26,47,22,4.265424934732508,Aleatória
1,23,27,4,6,26,1.7692307692307692,1.9285714285714286,0,1,13,2,13,14,18,0.9953784385316868,2.2199999999999998,0.54,10,13,13,13,0.8889686876112561,0.890448992522325,1.3343958351621,1.1451573950918745,1.9193605576701704,4.6575545596728976,7.095043854274259,24.098100805482417,-0.08,28,48,26,4.561286684176786,Aleatória
0,29,21,4,5,28,2.0714285714285716,1.4,2,1,16,1,14,15,17,0.9814538947451146,2.50671099251589,0.58,15,6,14,14,0.7858751946471527,0.8835226340609273,1.019803902718557,1.0135819625309703,1.5651880349091978,5.181293083848168,5.043901105967077,30.193919467933327,0.16,30,49,24,4.352381456471638,Aleatória
0,40,10,35,6,10,6.666666666666667,2.0,1,1,9,29,6,5,15,0.7219280945988233,1.269488085804668,0.22,34,5,5,5,0.3219280948873623,12.671051872498808,2.0,9.73618962581112,2.7430468337816527,6.6208757319236184,8.717246765566363,45.76734146536642,0.6,17,49,13,2.054429659926727,Humana
0,30,20,5,4,20,3.0,1.8181818181818181,1,0,7,1,10,11,15,0.9709505941661296,1.4572576985557497,0.42,20,9,10,10,0.7369655941662062,1.4142135623730951,0.8331955809010618,1.290115922299435,0.4633446129034421,3.5901439619545,1.84419291850114,14.598865884176316,0.2,24,49,19,3.9488106104538123,Humana
0,27,23,4,4,26,1.9285714285714286,1.7692307692307692,1,0,14,0,14,13,17,0.9953784385316868,2.2199999999999998,0.54,13,10,13,13,0.8889686876112561,1.0326308782000686,0.9730085108210398,1.0075163339804032,0.7340223821660877,4.909815586221727,2.1706281957633307,28.091591463139096,0.08,27,49,29,4.675310868912362,Aleatória
0,27,23,4,5,20,2.7,2.090909090909091,0,1,8,1,10,11,17,0.9953784385316868,1.4572576985557497,0.42,17,12,10,10,0.8889686876112561,1.2688577540449522,1.311109554714178,1.3265131692556305,0.37961112433100247,3.8228048714312926,1.7075074396854069,17.52377605335172,0.08,30,48,23,4.354552444952288,Aleatória
-1,25,25,7,7,22,2.0833333333333335,2.272727272727273,2,1,12,0,12,11,17,0.9999999997114609,1.8461852561430558,0.46,13,14,11,11,1.0,1.753963764987432,1.7104443383842525,1.7358665024067068,1.77651477138597,5.1647002995129965,5.366692694845319,31.085797074159355,0.0,31,49,26,4.528465488430548,Aleatória
1,19,31,3,6,28,1.3571428571428572,2.066666666666667,2,1,18,3,14,15,17,0.9580420219377606,2.646431559666716,0.58,5,16,14,14,0.6896598793878495,0.7178482586514923,1.3888444437333107,1.1713991552733123,1.9638261653898181,5.8311982350118035,6.898382237654279,37.76091268855239,-0.24,27,47,18,4.05869069550801,Aleatória
1,24,26,3,4,29,1.6,1.7333333333333334,2,0,17,1,15,15,18,0.9988455357066628,2.6305892875931813,0.6,9,11,14,15,0.9434164716336324,0.7118052168020874,0.9977753031397179,0.869226987360353,1.0038218236384704,5.216967729128709,2.8546712802768175,31.07270540278659,-0.04,29,50,26,4.555533151426995,Humana
0,33,17,4,3,26,2.357142857142857,1.3076923076923077,1,0,15,1,14,13,17,0.924818704684491,2.28219192882632,0.54,19,4,13,13,0.5994620704162712,1.2309777099724346,0.6056929133855238,1.1123449939023116,0.9401237730234976,5.319022753116405,2.377871790207522,32.659801906428726,0.32,31,46,22,4.273349455962949,Humana
0,37,13,7,3,19,3.7,1.3,0,0,9,4,10,10,17,0.8267463722040789,1.4,0.4,27,3,9,10,0.4344028241457749,1.7916472867168918,0.6403124237432849,1.8027756377319946,1.075264995759675,4.906705539358604,3.1017751479289943,28.995835068721377,0.48,29,50,16,3.5779107411359785,Aleatória
1,19,31,4,7,21,1.7272727272727273,2.8181818181818183,1,2,11,3,11,11,17,0.9580420219377606,1.6871277367170516,0.44,8,20,10,11,0.6896598793878495,0.9620913858416693,2.0368505911280073,1.6836599252229212,1.3955248035097034,5.1637498307487,4.18703941384967,31.2185436803934,-0.24,29,50,22,4.2575004135020675,Aleatória
1,24,26,5,4,25,1.8461538461538463,2.0,3,0,15,1,13,13,18,0.9988455357066628,2.2202702538204666,0.52,11,13,13,12,0.9434164716336324,1.4058205294228512,1.0377490433255416,1.2379597645716216,0.9975503810938182,5.66916082028276,2.6483654089831696,36.366747287691915,-0.04,29,46,27,4.582600814423441,Aleatória
0,26,24,3,2,36,1.368421052631579,1.3333333333333333,4,0,25,1,19,18,17,0.9988455357066628,3.7937316721138834,0.74,7,6,18,18,0.9434164716336324,0.581334790378277,0.4714045207910317,0.5309968298483378,1.1551094827407664,5.618655134097549,3.303081961931863,34.515941948557575,0.04,23,49,18,3.942495522291783,Humana
0,29,21,5,4,25,2.230769230769231,1.6153846153846154,1,0,13,1,13,13,18,0.9814538947451146,2.0903588208726274,0.52,16,8,12,13,0.7858751946471527,1.309952797378954,0.9230769230769231,1.1741798094210576,1.147166039007771,4.87876728151361,3.1885833225883697,27.30508311410511,0.16,29,50,28,4.691721466785482,Aleatória
-1,25,25,7,8,23,2.0833333333333335,2.0833333333333335,2,2,19,1,12,12,18,0.9999999997114609,2.6850698314941446,0.48,13,13,11,12,1.0,2.215789300051388,2.43099202430247,2.32588095615881,1.7866526148947448,6.574323109746109,4.278058008605219,45.28245724150612,0.0,22,50,19,3.823979141548664,Humana
0,27,23,3,3,39,1.35,1.15,4,0,32,0,20,20,16,0.9953784385316868,4.5431266766402185,0.8,7,3,20,19,0.8889686876112561,0.5722761571129799,0.47696960070847283,0.5361902647381804,2.067728053054609,6.503051345326004,6.285444234404538,44.52190373174688,0.08,25,48,17,3.652948861009533,Humana
1,22,28,2,4,34,1.2222222222222223,1.6470588235294117,4,0,22,2,18,17,17,0.9895875209335165,3.4770677301427426,0.7,4,11,17,17,0.8365012677171205,0.41573970964154905,0.7624400821656306,0.6452337023220694,1.862396009297552,5.276400521642552,7.54036908881199,30.396597479203717,-0.12,29,49,19,3.963809652538438,Humana
0,26,24,8,3,28,1.8571428571428572,1.6,2,0,17,5,14,15,18,0.9988455357066628,2.6312734559524604,0.58,12,9,14,14,0.9434164716336324,1.8070158058105028,0.7118052168020874,1.3619598384918277,3.3731037438856863,5.314438231078801,15.673683431952664,31.61021776457771,0.04,30,49,25,4.5342190211803395,Aleatória
0,28,22,8,5,27,2.0,1.5714285714285714,3,1,21,3,14,14,18,0.9895875209335165,2.9540480700218814,0.56,14,8,14,13,0.8365012677171205,2.138089935299395,1.1157499537009508,1.7187442022165664,2.401784563713836,6.624356951219731,7.881580713576203,45.847511722202626,0.12,25,41,24,4.186044837897654,Humana
1,24,26,3,3,28,1.7142857142857142,1.7333333333333334,2,0,16,0,14,15,17,0.9988455357066628,2.561952380509833,0.58,10,11,14,14,0.9434164716336324,0.8806305718527109,0.8537498983243799,0.8668831096535542,0.5634358234130649,4.9385138003196625,1.5647933023553922,27.834093463890113,-0.04,32,49,26,4.567040216926578,Aleatória
0,27,23,5,4,24,2.25,1.7692307692307692,0,0,11,1,12,13,18,0.9953784385316868,1.8894443627691184,0.5,15,10,12,12,0.8889686876112561,1.2332207155790618,0.9730085108210399,1.131370849898476,0.9943689110435824,4.367474905819444,3.125,22.12355530447473,0.08,29,47,26,4.561286684176786,Aleatória
0,48,2,48,1,2,48.0,1.0,0,0,2,47,1,2,11,0.24229218879387582,0.31048349392520047,0.06,47,0,1,1,0.058893689053568565,0.0,0.0,22.15601247717849,0.7071067811865474,5.426952756200196,1.4999999999999998,32.16640553709475,0.92,13,49,3,0.3014969295343807,Humana
1,24,26,4,7,19,2.4,2.6,0,2,8,3,10,10,18,0.9988455357066628,1.3856406460551016,0.4,14,16,10,9,0.9434164716336324,1.1135528725660044,2.28910462845192,1.8027756377319946,1.3824835659767247,4.0414518843273814,4.124260355029586,20.000000000000014,-0.04,25,48,24,4.34389537982896,Aleatória
0,26,24,9,8,25,2.0,1.8461538461538463,3,1,20,1,13,13,18,0.9988455357066628,2.808843178249722,0.52,13,11,12,13,0.9434164716336324,2.2188007849009166,1.9551176964828976,2.092533924420837,2.4442408818163264,6.669101391037841,7.873897005113224,46.27012237545747,0.04,29,50,19,3.996630848284676,Humana
1,24,26,7,9,22,2.1818181818181817,2.1666666666666665,2,2,18,2,11,12,18,0.9988455357066628,2.5472337937456775,0.46,13,14,11,11,0.9434164716336324,2.289032420366213,2.640496586292477,2.478642228476387,1.7877734774349734,6.544780330204634,4.414964828402367,44.98568008529588,-0.04,22,41,19,3.772924455774821,Humana
1,21,29,4,5,26,1.5,2.230769230769231,2,1,17,1,14,13,18,0.9814538947451146,2.4674683381960554,0.54,7,16,13,13,0.7858751946471527,0.9819805060619657,1.3674145257408599,1.2383891479481843,1.1016527653294579,6.006771155142103,2.8031928341243146,39.70598237324571,-0.16,28,49,22,4.303149662852282,Humana
1,23,27,3,4,32,1.3529411764705883,1.6875,2,0,24,1,17,16,17,0.9953784385316868,3.4153184331772053,0.66,6,11,16,16,0.8889686876112561,0.6809315825170721,1.1021995055342748,0.925111364998409,1.5631543122214964,6.402914175501824,4.035803753983312,43.6467608989728,-0.08,27,49,20,4.229871195093384,Aleatória
0,28,22,5,4,27,2.0,1.5714285714285714,1,0,16,1,14,14,18,0.9895875209335165,2.409647277092646,0.56,14,8,13,14,0.8365012677171205,1.2535663410560174,0.9035079029052513,1.1134612334371354,1.3606142146334386,5.50550798412307,3.8908194888990497,34.2593679660668,0.12,31,50,26,4.561286684176786,Humana
0,30,20,3,2,36,1.5789473684210527,1.1111111111111112,3,0,26,1,19,18,17,0.9709505941661296,3.830456891808078,0.74,11,2,18,18,0.7369655941662062,0.6740130776245105,0.3142696805273545,0.5796651510683032,1.427948667227124,5.930074970696579,4.013213610586011,38.257448822241244,0.2,26,49,16,3.754342869421053,Humana
1,24,26,3,2,40,1.2,1.2380952380952381,6,0,33,1,20,21,15,0.9988455357066628,4.7018719676316145,0.82,4,5,20,20,0.9434164716336324,0.5099019513592785,0.4259177099999599,0.4691557088212523,2.036786905463754,6.452165626553264,6.405741417092768,43.9430187541438,-0.04,25,49,14,3.391169644053742,Humana
0,26,24,6,5,26,2.0,1.7142857142857142,2,1,17,1,13,14,18,0.9988455357066628,2.459349507491768,0.54,13,10,13,13,0.9434164716336324,1.5191090506254998,1.1605769149479945,1.3527394346481239,1.6166092027204209,6.062745714548984,4.772751180631573,40.230414046747754,0.04,28,49,27,4.610518477796142,Humana
1,24,26,4,7,25,1.8461538461538463,2.0,2,1,15,3,13,13,18,0.9988455357066628,2.2292599668948436,0.52,11,13,12,13,0.9434164716336324,1.0986812966989,1.6641005886756874,1.4121199808219862,1.939223241632644,5.627715422038971,6.943364826669249,35.8450640162633,-0.04,29,50,27,4.615422010169679,Humana
-1,25,25,4,7,22,2.0833333333333335,2.272727272727273,1,2,10,3,12,11,18,0.9999999997114609,1.7344739836619056,0.46,13,14,11,11,1.0,0.9537935951882998,2.0489868490153897,1.5784465096235953,1.768687984575214,4.448277053663306,5.521255822842816,22.443848303065447,0.0,29,47,27,4.586183358692583,Aleatória
-1,25,25,4,5,28,1.6666666666666667,1.7857142857142858,1,1,17,1,15,14,17,0.9999999997114609,2.554133904085689,0.58,10,11,14,14,1.0,0.9428090415820634,1.1450871101343856,1.0470501000475156,1.4695657385252425,5.542732206609343,4.512850494774634,34.6346397993039,0.0,29,49,28,4.664653803789036,Aleatória
1,22,28,3,4,24,1.8333333333333333,2.1538461538461537,1,0,11,1,12,13,18,0.9895875209335165,1.8894443627691184,0.5,10,15,12,12,0.8365012677171205,0.8975274678557508,1.166596222161777,1.0583005244258363,0.6074429030505436,4.225153931291723,2.040816326530612,21.219664336322765,-0.12,29,48,26,4.528465488430548,Aleatória
1,20,30,3,5,21,1.8181818181818181,2.727272727272727,0,1,8,2,11,11,17,0.9709505941661296,1.5768322675541622,0.44,9,19,11,10,0.7369655941662062,0.8331955809010619,1.28564869306645,1.1748043621200077,0.46846424436647405,3.875077657958698,2.2931263222058877,17.103183713222307,-0.2,31,47,20,4.1478182057277895,Aleatória
1,16,34,3,10,26,1.2307692307692308,2.4285714285714284,5,2,18,7,13,14,17,0.9043814574359548,2.586194114910944,0.54,3,20,13,13,0.5563933485243853,0.5756395979652217,2.351725376164904,1.8399618293887738,3.2863189801555395,6.201319470813479,14.423641739057333,41.61905059668746,-0.36,26,48,21,4.048595185796918,Humana
0,27,23,5,4,30,1.6875,1.5333333333333334,3,0,20,1,16,15,18,0.9953784385316868,2.9522195040342107,0.62,11,8,15,15,0.8889686876112561,1.1575161985907585,0.8844332774281067,1.0372861413428083,1.865189418183111,5.85342104717921,5.663018306028303,37.579685226185845,0.08,30,49,27,4.577697282049904,Aleatória
1,13,37,3,8,17,1.4444444444444444,4.111111111111111,0,4,9,5,9,9,16,0.8267463722040789,1.3676256797823005,0.36,4,28,9,8,0.4344028241457749,0.6849348892187752,2.806517986736686,2.4393887111222385,1.1543112117440446,5.24365712262047,2.8182882526127306,32.22436978663961,-0.48,26,47,16,3.494034859615898,Aleatória
-1,25,25,4,4,22,2.272727272727273,2.0833333333333335,0,0,9,0,11,12,18,0.9999999997114609,1.6517869111964776,0.46,14,13,11,11,1.0,1.052348809344566,1.1873172373979173,1.1287613031084496,0.38061367188702994,3.7715708732111706,1.7115277936760913,17.0006809089989,0.0,31,47,24,4.474330162437656,Aleatória
0,27,23,7,5,23,2.25,1.9166666666666667,0,2,12,2,12,12,18,0.9953784385316868,1.9415457759218557,0.48,15,11,11,12,0.8889686876112561,1.5343293866268306,1.6051133570215186,1.5789412767913678,1.7044788755319202,4.932630027926818,5.093791947610586,27.343048201175485,0.08,23,50,20,4.156304282370468,Aleatória
0,28,22,8,8,19,2.8,2.2,1,1,8,0,10,10,18,0.9895875209335165,1.4560219778561034,0.4,18,12,9,10,0.8365012677171205,2.08806130178211,2.0396078054371136,2.085665361461421,1.769054250308142,4.105266665938179,5.0475624256837115,19.46066215735138,0.12,28,50,26,4.466405641207214,Aleatória
0,28,22,3,3,37,1.4736842105263157,1.1578947368421053,3,0,28,0,19,19,16,0.9895875209335165,4.057388322554299,0.76,9,3,19,18,0.8365012677171205,0.5954583420518295,0.48808518397345807,0.5668594533825794,1.6232333871683666,6.160202995453879,4.619203329369796,40.83646468739694,0.12,25,46,15,3.4620672529236014,Humana
-1,25,25,4,5,24,2.0833333333333335,1.9230769230769231,1,1,14,1,12,13,18,0.9999999997114609,2.090454496036687,0.5,13,12,12,12,1.0,1.2555432644432802,1.3278981924332363,1.296148139681572,0.8817334283548109,5.536772377167793,2.2959183673469394,35.02780556006472,0.0,27,46,22,4.294663586209603,Humana
0,26,24,8,8,23,2.1666666666666665,2.0,1,1,11,0,12,12,18,0.9988455357066628,2.071134954559939,0.48,14,12,12,11,0.9434164716336324,1.863389981249825,1.8708286933869707,1.8689717910004835,2.5594990609827133,4.559976510926589,8.423973060246865,22.248822268853946,0.04,25,47,24,4.265424934732508,Humana
-1,25,25,6,4,25,1.9230769230769231,1.9230769230769231,2,0,14,2,13,13,18,0.9999999997114609,2.1376622745419818,0.52,12,12,13,12,1.0,1.3846153846153846,1.1409536133993328,1.2686478848054341,1.50068917991231,5.279426215499317,4.885326557093424,32.15928430195608,0.0,28,48,26,4.604764945046352,Aleatória
0,33,17,6,2,23,2.75,1.4166666666666667,0,0,9,4,12,12,17,0.924818704684491,1.7915356541246954,0.48,21,5,12,11,0.5994620704162712,1.299038105676658,0.4930066485916347,1.1873172373979173,1.481863188959928,3.9351547782481964,5.550753476182386,17.254229832933888,0.32,26,47,17,3.9239139359380153,Aleatória
-1,25,25,7,3,28,1.7857142857142858,1.6666666666666667,3,0,16,4,14,15,18,0.9999999997114609,2.5697470692657673,0.58,11,10,14,14,1.0,1.5665508713900935,0.699205898780101,1.2004755300364973,2.933855026205264,5.031038788984197,13.069494820769208,28.25358183527931,0.0,30,48,26,4.501397825434102,Aleatória
1,21,29,3,5,27,1.5,2.0714285714285716,3,1,18,2,14,14,17,0.9814538947451146,2.593530412391573,0.56,7,15,13,14,0.7858751946471527,0.823754471047914,1.4374722712498649,1.2058530725810095,1.2719912743458404,6.122285994125953,3.247386888273315,40.942125369250974,-0.16,24,50,18,3.944666510772432,Humana
-1,25,25,4,4,36,1.3157894736842106,1.3888888888888888,6,0,32,0,19,18,18,0.9999999997114609,4.502488200983985,0.74,6,7,18,18,1.0,0.9206766149755738,0.9509579315902049,0.9362436797669607,2.4110147241358773,6.696704815056409,6.948066666666671,46.47649127095195,0.0,22,49,19,3.5647033558391743,Humana
0,44,6,15,2,8,11.0,1.2,0,0,4,13,4,5,13,0.5293608649988253,0.6225752966509353,0.18,40,1,4,4,0.18442457113742744,4.743416490252569,0.4,5.813989089756057,0.719391423111886,4.827247553133164,1.6231078866756912,28.65466936326428,0.76,20,48,8,1.9440861654153405,Humana
-1,25,25,3,4,34,1.4705882352941178,1.3888888888888888,4,0,27,1,17,18,17,0.9999999997114609,3.8327535793473606,0.7,8,7,17,17,1.0,0.7759356446042893,0.8906233078822998,0.8378787599208675,1.6831778901466046,6.485392015849818,4.367225527312059,44.37437423567895,0.0,23,49,18,3.8084781954139455,Humana
0,26,24,5,5,25,2.0,1.8461538461538463,2,2,15,0,13,13,18,0.9988455357066628,2.238213573366045,0.52,13,11,13,12,0.9434164716336324,1.3008872711759818,1.4058205294228512,1.356553237580646,1.341223446856029,5.5976909440705915,3.419557283320064,35.39233590063451,0.04,30,44,27,4.697474999535273,Aleatória
0,26,24,4,4,22,2.3636363636363638,2.0,0,0,7,0,11,12,18,0.9988455357066628,1.6517869111964774,0.46,15,12,11,11,0.9434164716336324,0.9791208740244551,1.0,1.0065945132861065,0.4143667392107607,3.6118099964930344,2.074640788594342,14.857365082922065,0.04,29,49,21,4.316827716832514,Aleatória
1,22,28,2,7,26,1.5714285714285714,2.1538461538461537,1,1,12,5,14,13,18,0.9895875209335165,2.351254984045754,0.54,8,15,13,13,0.8365012677171205,0.4948716593053935,1.656973786810617,1.238389147948184,2.7397667165147985,4.620972052034711,11.523729442750124,22.57612528205877,-0.12,30,48,22,4.308903195602073,Aleatória
1,21,29,3,7,25,1.6153846153846154,2.230769230769231,1,2,13,4,13,13,18,0.9814538947451146,2.1469979040511427,0.52,8,16,13,12,0.7858751946471527,0.737820234355803,1.7608497141937842,1.3846153846153846,2.224279835390946,4.792297371572902,8.030978509373568,25.818266296280285,-0.16,33,48,25,4.550629619053459,Aleatória
1,22,28,3,5,22,2.0,2.3333333333333335,0,2,7,2,11,12,18,0.9895875209335165,1.7459667808981936,0.46,11,16,11,11,0.8365012677171205,0.7385489458759964,1.4337208778404378,1.1666441621738033,1.1375995835530182,4.373186822517374,3.6002546296296307,21.87054801182395,-0.12,29,46,26,4.501397825434102,Aleatória
0,31,19,4,3,22,2.5833333333333335,1.7272727272727273,1,0,7,1,12,11,17,0.9580420219377606,1.6995293466133499,0.46,19,8,11,11,0.6896598793878495,1.1873172373979173,0.616575453011388,1.048898963636071,0.5529693370839404,3.906494665583444,2.125642115704822,17.617835150179104,0.24,27,49,22,4.0999979678969245,Aleatória
1,20,30,5,10,23,1.6666666666666667,2.5,2,2,13,5,12,12,17,0.9709505941661296,2.0023985617254123,0.48,8,18,11,12,0.7369655941662062,1.178511301977579,2.3979157616563596,1.9346977943739831,2.920176929117582,5.2156603613749475,11.958560654823573,31.279859223736928,-0.2,28,50,27,4.528465488430548,Humana
0,26,24,15,18,13,3.7142857142857144,3.4285714285714284,2,3,11,3,7,7,17,0.9988455357066628,1.5497096502248415,0.28,19,17,6,7,0.9434164716336324,4.919764387920733,5.948760803902003,5.460432815318969,1.8969502787633812,6.620672406966486,4.894328516796043,45.79769249991454,0.04,18,50,13,2.8492505273814155,Humana
1,20,30,3,5,23,1.6666666666666667,2.5,1,4,12,2,12,12,17,0.9709505941661296,1.9415457759218557,0.48,8,18,12,11,0.7369655941662062,0.7453559924999298,1.8027756377319946,1.4409680388158819,1.1910579769391658,4.752273848005866,2.9709399223722324,26.322237627586684,-0.2,23,46,17,3.8719495984257715,Humana
1,22,28,4,6,22,2.0,2.3333333333333335,1,1,10,2,11,12,18,0.9895875209335165,1.675828153481138,0.46,11,16,11,11,0.8365012677171205,1.044465935734187,1.5456030825826172,1.3400900006454295,1.0899230387299281,4.327530646606958,3.6199734072022194,22.59056304137822,-0.12,34,48,31,4.805745651521058,Aleatória
0,28,22,4,4,33,1.6470588235294117,1.2941176470588236,4,0,25,0,17,17,17,0.9895875209335165,3.552126123886932,0.68,11,5,16,17,0.8365012677171205,0.903664205631601,0.823529411764706,0.8823529411764706,1.7591111111111108,6.435299561815235,4.843674074074074,43.967674152514086,0.12,27,50,21,4.075101293381128,Humana
1,20,30,2,5,34,1.1764705882352942,1.6666666666666667,5,1,25,3,17,18,17,0.9709505941661296,3.618010503025109,0.7,3,12,17,17,0.7369655941662062,0.3812200410828153,1.0540925533894596,0.8378787599208675,2.557478773014276,6.15940654034943,10.230530016224987,40.883750097024695,-0.2,29,48,19,3.926084924418664,Aleatória
0,26,24,6,3,28,1.8571428571428572,1.6,1,0,16,3,14,15,18,0.9988455357066628,2.5305335405799307,0.58,12,9,14,14,0.9434164716336324,1.3552618543578767,0.7118052168020874,1.0794810925861056,2.2088179362579554,5.067882343122759,8.87067471886714,29.122923812442142,0.04,32,48,26,4.604764945046351,Aleatória
0,27,23,2,2,40,1.2857142857142858,1.15,4,0,32,0,21,20,17,0.9953784385316868,4.628995571395592,0.82,6,3,20,20,0.8889686876112561,0.45175395145262565,0.3570714214271425,0.4139161645970034,1.3552879972742162,6.217234799462829,2.836805555555556,41.36659017744225,0.08,27,49,12,3.27523199947958,Humana
-1,25,25,4,4,23,2.0833333333333335,2.0833333333333335,2,0,10,0,12,12,18,0.9999999997114609,1.8247191564731269,0.48,13,13,12,11,1.0,1.2555432644432805,1.0374916331657276,1.1516895800904379,0.6553843283538684,4.0514262233836655,1.9577588333653124,18.845322118773982,0.0,31,46,27,4.631832608042798,Aleatória
0,27,23,5,3,28,1.8,1.6428571428571428,2,0,17,2,15,14,18,0.9953784385316868,2.554133904085689,0.58,12,9,14,14,0.8889686876112561,1.2220201853215575,0.8112726208286106,1.0470501000475156,1.469565738525242,5.542732206609343,4.512850494774632,34.6346397993039,0.08,31,49,27,4.631832608042798,Humana
0,29,21,6,3,28,1.9333333333333333,1.5,0,0,16,3,15,14,16,0.9814538947451146,2.616027522790997,0.58,14,7,14,14,0.7858751946471527,1.4817407180595248,0.6267831705280087,1.1713991552733123,2.3499794983551765,5.020208529098768,8.360973360686518,27.508120889273577,0.16,28,49,23,4.381620107948733,Aleatória
0,31,19,8,4,19,3.1,1.9,0,0,7,4,10,10,17,0.9580420219377606,1.3564659966250534,0.4,21,9,10,9,0.6896598793878495,2.1189620100417095,0.9433981132056604,1.746424919657298,1.5769921338480306,3.865543459191434,5.403117441547972,17.335538752362954,0.24,31,47,26,4.4393379782107685,Aleatória
0,40,10,14,3,13,5.714285714285714,1.4285714285714286,0,0,7,11,7,7,14,0.7219280945988233,1.020588065773846,0.28,33,3,7,6,0.3219280948873623,4.266624149448022,0.7284313590846836,3.7361990944634345,1.6275436383141832,5.7411555506157175,4.7827151944187944,37.632277885139466,0.6,27,44,16,3.1718648798673303,Humana
0,27,23,7,6,19,2.7,2.3,1,1,7,1,10,10,18,0.9953784385316868,1.3266499161421597,0.4,17,13,9,10,0.8889686876112561,1.8466185312619388,1.4177446878757827,1.6583123951777,1.2827937205672124,3.710645297474069,4.008264462809917,16.277892561983478,0.08,30,50,27,4.588354347173232,Aleatória
0,28,22,9,7,24,2.3333333333333335,1.6923076923076923,2,1,18,2,12,13,18,0.9895875209335165,2.539685019840059,0.5,16,9,12,12,0.8365012677171205,2.4608038433722332,1.6354070481130227,2.0976176963403033,2.236303163866934,6.545400584754549,6.822314049586777,45.09446547683432,0.12,26,49,21,4.12832696763562,Humana
1,23,27,4,4,28,1.6428571428571428,1.8,4,0,20,0,14,15,17,0.9953784385316868,2.8850649906024657,0.58,9,12,14,14,0.8889686876112561,1.1088696211614302,1.1661903789690602,1.1415824384308173,1.10990898460734,6.158950698993005,2.5057741488624856,41.139130072188,-0.08,30,47,22,4.238357271736062,Humana
1,24,26,2,2,43,1.0909090909090908,1.1818181818181819,6,0,38,0,22,22,16,0.9988455357066628,5.368947755380005,0.88,2,4,22,21,0.9434164716336324,0.28747978728803447,0.38569460791993493,0.3431742925123068,2.1192517713040697,6.622887990222122,5.491228070175438,45.7160712088564,-0.04,22,48,12,2.939507788271281,Humana
1,22,28,3,4,27,1.5714285714285714,2.0,2,0,17,1,14,14,18,0.9895875209335165,2.5152335875619984,0.56,8,14,13,14,0.8365012677171205,0.8206518066482897,1.2535663410560174,1.0809104250301114,0.9418829309543281,5.721084316223108,2.3409355275452404,36.734497940273684,-0.12,29,50,21,4.224117662343593,Humana
0,28,22,2,2,36,1.4736842105263157,1.2222222222222223,3,0,24,0,19,18,16,0.9895875209335165,3.7884561499375966,0.74,9,4,18,18,0.8365012677171205,0.49930699897395464,0.41573970964154905,0.47739247926096473,0.6227523687795278,5.299507596968428,1.3878205128205132,30.61464254659427,0.12,25,48,15,3.727836761836844,Humana
1,24,26,4,3,35,1.3333333333333333,1.4444444444444444,4,0,28,1,18,18,17,0.9988455357066628,3.960000000000001,0.72,6,8,18,17,0.9434164716336324,0.816496580927726,0.7617394000445605,0.7915448249319448,1.8801614609342263,6.548150621612508,5.271202892572014,45.05555563363207,-0.04,28,48,23,4.107012837388965,Humana
1,24,26,4,4,25,1.8461538461538463,2.0,1,0,11,0,13,13,17,0.9988455357066628,2.0023985617254123,0.52,11,13,12,13,0.9434164716336324,0.8634593969478326,1.0377490433255416,0.9576845844606717,0.6793680904459196,4.125690605888488,2.3742351716961494,19.411893817169204,-0.04,30,50,26,4.517808423307221,Aleatória
0,31,19,6,4,24,2.3846153846153846,1.5833333333333333,0,0,13,2,13,12,18,0.9580420219377606,2.080865204668481,0.5,18,7,12,12,0.6896598793878495,1.6888075692384727,0.8620067027323834,1.4142135623730951,1.442497833620557,4.967732856912203,3.98,27.99217554096507,0.24,31,49,25,4.441508966691418,Aleatória
1,24,26,9,9,5,8.0,8.666666666666666,0,3,0,0,3,3,15,0.9988455357066628,0.5153639490690051,0.12,21,23,2,3,0.9434164716336324,0.816496580927726,0.4714045207910317,0.7453559924999299,-0.6260990336999436,4.548896665419827,2.040000000000002,23.21933517201336,-0.04,19,50,10,2.84221263157627,Humana
1,21,29,4,8,23,1.75,2.4166666666666665,1,1,12,4,12,12,18,0.9814538947451146,1.889338508579127,0.48,9,17,12,11,0.7858751946471527,1.0103629710818451,1.9346977943739834,1.578941276791368,2.2125588301496806,4.93301935630747,8.526167549910383,28.552362788232568,-0.16,28,46,29,4.7081320646586,Humana
1,21,29,3,5,29,1.4,1.9333333333333333,2,1,17,2,15,15,18,0.9814538947451146,2.6758176320519307,0.6,6,14,15,14,0.7858751946471527,0.6110100926607788,1.1813363431112902,0.9775252199076785,1.7763573493184426,5.216178312098981,5.946457544618713,30.16756655535094,-0.16,30,47,24,4.377278130987435,Aleatória
0,28,22,6,5,28,1.8666666666666667,1.5714285714285714,1,1,19,1,15,14,18,0.9895875209335165,2.7429181540833487,0.58,13,8,14,14,0.8365012677171205,1.4079141387961918,1.1157499537009508,1.2837593426887093,1.9910687753256269,6.135395718279877,6.180534472742268,40.81397776423825,0.12,30,49,26,4.544876086303667,Aleatória
0,27,23,6,4,29,1.8,1.5333333333333334,3,0,20,2,15,15,17,0.9953784385316868,2.8844410203711917,0.6,12,8,14,15,0.8889686876112561,1.4236104336041748,0.8844332774281067,1.1925695879998877,2.0788444478318358,6.152371887940398,6.9580078125,41.03735207100588,0.08,31,50,25,4.455748576083887,Humana
1,21,29,4,6,22,1.9090909090909092,2.4166666666666665,0,2,9,2,11,12,18,0.9814538947451146,1.6638509548634457,0.46,10,17,11,11,0.7858751946471527,0.9958591954639383,1.552328000849763,1.3400900006454297,1.3067191611168918,4.094970169108076,4.154541828254848,19.070087288287336,-0.16,27,47,23,4.354552444952287,Aleatória
1,21,29,5,7,20,1.9090909090909092,2.9,0,3,9,2,11,10,18,0.9814538947451146,1.5374004032782091,0.42,10,19,10,10,0.7858751946471527,1.1642044068059725,2.1656407827707715,1.7855555485002543,1.324347217635679,4.4602833987823045,3.5323385450285216,22.922362693781725,-0.16,30,49,25,4.40868777094518,Aleatória
1,24,26,4,7,18,2.4,2.888888888888889,0,2,5,3,10,9,18,0.9988455357066628,1.2147427711248173,0.38,14,17,9,9,0.9434164716336324,1.019803902718557,1.9688939051854832,1.5630781478860523,1.1198720612960906,3.4605481035341503,3.9023632128588415,14.22443277366036,-0.04,33,48,22,4.311074184082723,Aleatória
0,30,20,5,3,21,2.727272727272727,1.8181818181818181,0,0,9,2,11,11,17,0.9709505941661296,1.6390240998838306,0.44,19,9,11,10,0.7369655941662062,1.4826824027545538,0.8331955809010618,1.28564869306645,0.6374567632396722,4.208143347379189,2.4147499999999993,20.151933583087285,0.2,26,46,20,4.191296466597355,Humana
0,28,22,5,4,24,2.1538461538461537,1.8333333333333333,1,0,14,1,13,12,18,0.9895875209335165,2.090454496036687,0.5,15,10,12,12,0.8365012677171205,1.4058205294228512,1.1426091000668408,1.296148139681572,0.8817334283548109,5.536772377167793,2.2959183673469394,35.02780556006472,0.12,26,49,22,4.32173124920605,Humana
-1,25,25,4,4,25,1.9230769230769231,1.9230769230769231,1,0,16,0,13,13,18,0.9999999997114609,2.426849809938802,0.52,12,12,13,12,1.0,1.2064913185660093,1.2064913185660093,1.2064913185660093,0.6733432116010377,5.470556259615709,1.7084076938330357,33.71522324268304,0.0,30,46,16,3.8555390005526533,Humana
1,24,26,8,6,26,1.8461538461538463,1.8571428571428572,2,1,17,2,13,14,18,0.9988455357066628,2.491666109253004,0.54,11,12,13,13,0.9434164716336324,1.8747780933775295,1.3552618543578767,1.6262591407481592,2.564645153771965,5.890710269913868,9.208625669323874,38.31449965050227,-0.04,29,49,28,4.681064401662153,Aleatória
1,23,27,3,5,27,1.6428571428571428,1.9285714285714286,1,1,14,2,14,14,17,0.9953784385316868,2.3337523433303717,0.56,9,13,13,14,0.8889686876112561,0.6102859818083951,1.2797480619406367,1.0126747770541304,1.4696454921471684,4.776696359334328,4.844657310462611,25.447407038929782,-0.08,30,50,25,4.4743301624376555,Aleatória
0,47,3,17,1,6,11.75,1.0,0,0,3,16,4,3,12,0.32744491886593724,0.4903060268852505,0.14,43,0,3,3,0.08926733809708741,4.437059837324712,0.0,6.288960200872897,0.3631673733112773,4.380163641721164,1.4763280903040703,23.917145855077912,0.88,16,33,6,1.6680288444741767,Humana
0,27,23,5,4,28,1.8,1.6428571428571428,2,0,18,1,15,14,18,0.9953784385316868,2.6312734559524604,0.58,12,9,14,14,0.8889686876112561,1.2220201853215573,0.9715336077668174,1.110965771971518,1.4643733296251937,5.907262264137539,4.113941884682639,38.59749964653876,0.08,29,47,24,4.360867533114316,Humana
1,24,26,3,6,23,2.0,2.1666666666666665,1,1,10,3,12,12,18,0.9988455357066628,1.889338508579127,0.48,12,14,11,12,0.9434164716336324,0.9128709291752769,1.404358295529393,1.1873172373979173,1.3325013369695669,4.0789499720889975,5.341090538474606,18.57116994326912,-0.04,29,50,24,4.377278130987436,Aleatória
-1,25,25,4,6,24,2.0833333333333335,1.9230769230769231,1,1,12,2,12,13,18,0.9999999997114609,1.972308292331602,0.5,13,12,12,12,1.0,1.114924013354971,1.4390989949130544,1.296148139681572,1.432816821076568,4.7156781951320275,4.5068027210884365,25.53792930260836,0.0,31,49,25,4.4743301624376555,Aleatória
0,26,24,3,3,35,1.4444444444444444,1.3333333333333333,5,0,27,0,18,18,17,0.9988455357066628,3.8576676891614197,0.72,8,6,18,17,0.9434164716336324,0.7617394000445605,0.6666666666666666,0.7179359990733382,1.5189176983514379,6.356619211821818,3.6452006167306097,43.11758199626874,0.04,29,47,20,4.014302782900043,Humana
0,26,24,6,7,17,2.888888888888889,2.6666666666666665,1,1,6,1,9,9,17,0.9988455357066628,1.109233969908964,0.36,17,15,8,9,0.9434164716336324,1.7284832429004495,1.8257418583505538,1.7812466157645999,0.8677135136372387,3.652188311303068,2.8448424654423223,16.44032494533795,0.04,32,50,25,4.49564429268431,Aleatória
0,26,24,6,7,18,2.888888888888889,2.4,0,1,6,1,9,10,16,0.9988455357066628,1.2147427711248173,0.38,17,14,9,9,0.9434164716336324,1.523478800089121,1.8,1.69241423061195,1.1085389508416075,3.4605481035341503,3.5078566645092026,14.22443277366036,0.04,31,49,23,4.4250983688183,Aleatória
1,20,30,3,8,24,1.6666666666666667,2.3076923076923075,1,2,14,5,12,13,18,0.9709505941661296,2.1283796653792764,0.5,8,17,12,12,0.7369655941662062,0.8498365855987975,2.014738592878276,1.6,2.28515625,5.370500274029839,8.5205078125,32.92070523222665,-0.2,31,42,24,4.42292738033765,Aleatória
1,21,29,4,6,19,2.1,2.9,0,1,6,2,10,10,17,0.9814538947451146,1.3114877048604001,0.4,11,19,9,10,0.7858751946471527,1.044030650891055,1.5132745950421556,1.3601470508735443,0.7153439566318128,3.223748847263667,2.9401022644265886,11.955110870740942,-0.16,27,50,24,4.425098368818299,Aleatória
0,28,22,6,5,25,2.1538461538461537,1.6923076923076923,2,1,16,1,13,13,17,0.9895875209335165,2.3344378338263794,0.52,15,9,13,12,0.8365012677171205,1.790837957972741,1.1357556200179537,1.517160224870463,1.7161784078303866,5.917267803944109,4.7753781695865065,38.80065126340895,0.12,30,43,29,4.7081320646586,Aleatória
0,30,20,5,4,21,2.727272727272727,1.8181818181818181,0,0,9,1,11,11,18,0.9709505941661296,1.5894653189044423,0.44,19,9,11,10,0.7369655941662062,1.4826824027545538,0.9359663764533636,1.3205308223939953,0.5559630227297911,4.069096905394733,1.8540239437568786,19.55748642028587,0.2,29,48,23,4.263253946251858,Aleatória
0,27,23,7,4,25,2.076923076923077,1.7692307692307692,0,0,12,3,13,13,18,0.9953784385316868,2.1094074997496333,0.52,14,10,12,13,0.8889686876112561,1.5423028965971863,0.9730085108210399,1.298611001241087,2.3556779580777367,4.542715417997652,9.408938134810711,22.810351254680516,0.08,29,50,29,4.751610325528165,Aleatória
0,29,21,4,3,30,1.8125,1.4,1,0,19,1,16,15,17,0.9814538947451146,2.841760018017004,0.62,13,6,15,15,0.7858751946471527,1.0734727523323542,0.6110100926607788,0.9043771463791087,1.3624944200504339,5.642142279006842,3.80388671988812,35.52070002471883,0.16,31,49,25,4.528465488430548,Aleatória
0,29,21,5,5,32,1.8125,1.2352941176470589,2,1,22,0,16,17,17,0.9814538947451146,3.3082321563034243,0.66,13,4,16,16,0.7858751946471527,0.9499177595981665,0.9411764705882354,0.9884549351697024,2.5936255067236225,5.682458474853093,9.428168635875405,35.43754696823427,0.16,26,49,18,3.650627653482639,Humana
1,23,27,4,4,30,1.4375,1.8,1,0,19,0,16,15,17,0.9953784385316868,2.841760018017004,0.62,7,12,15,15,0.8889686876112561,0.8637671850678283,0.9092121131323903,0.9043771463791087,1.3624944200504339,5.642142279006842,3.803886719888121,35.52070002471883,-0.08,30,49,26,4.482816239080334,Aleatória
1,24,26,5,4,34,1.411764705882353,1.4444444444444444,5,0,30,1,17,18,17,0.9988455357066628,4.210700654285461,0.7,7,8,17,17,0.9434164716336324,1.140630554686195,1.0122703976826999,1.0766539246523867,2.2453872826048658,6.73764826698975,6.399523903987307,46.892783556315216,-0.04,25,46,16,3.583162369835679,Humana
0,27,23,6,4,21,2.4545454545454546,2.090909090909091,0,0,8,2,11,11,18,0.9953784385316868,1.5252540771950096,0.44,16,12,10,11,0.8889686876112561,1.4373989364401722,1.1642044068059725,1.3205308223939953,1.0297061618164447,3.732428861194271,3.6151703690393298,16.3615203706892,0.08,33,50,28,4.681064401662154,Aleatória
0,41,9,5,1,18,4.1,1.0,0,0,9,4,10,9,14,0.6800770454397409,1.5477725931156683,0.38,31,0,9,9,0.2863041851566411,0.8306623862918076,0.0,1.661024614532579,0.1824820432233132,4.4969917536355,1.240225964097353,22.885730116723984,0.64,19,46,6,2.516108422554711,Humana
0,27,23,4,3,34,1.588235294117647,1.2777777777777777,2,0,25,1,17,18,17,0.9953784385316868,3.5958309192730407,0.7,10,5,17,17,0.8889686876112561,0.8442764761416073,0.6502611061510903,0.766651877999928,1.7624563572654584,6.2348564386050755,5.251736111111108,41.81077657132911,0.08,27,49,23,4.1319095119047615,Humana
1,24,26,4,4,26,1.7142857142857142,2.0,1,0,14,0,14,13,18,0.9988455357066628,2.201908263302538,0.54,10,13,13,13,0.9434164716336324,0.880630571852711,1.1766968108291043,1.0436298373041015,0.8848926060877839,4.965292111289962,2.441748250417172,28.83886311608344,-0.04,30,49,23,4.238357271736062,Aleatória
0,29,21,7,3,26,2.230769230769231,1.5,1,0,13,4,13,14,18,0.9814538947451146,2.2821919288263204,0.54,16,7,13,13,0.7858751946471527,1.624516313995606,0.6267831705280087,1.26794390878694,2.568762803281006,4.6729153389026,10.518713089261373,23.68102304783856,0.16,27,48,25,4.51205489055743,Aleatória
-1,25,25,3,5,28,1.6666666666666667,1.7857142857142858,1,1,13,2,15,14,18,0.9999999997114609,2.5541339040856883,0.58,10,11,14,14,1.0,0.699205898780101,1.0126747770541304,0.8668831096535543,1.8338098917519041,4.592074460670294,7.578192597340162,22.369517214491974,0.0,28,47,22,4.129236619374021,Humana
1,22,28,3,6,28,1.4666666666666666,2.0,2,1,15,3,15,14,16,0.9895875209335165,2.5226176880375673,0.58,7,14,14,14,0.8365012677171205,0.6182412330330469,1.3093073414159542,1.0470501000475159,2.3707650867093815,4.783688982922644,9.938248455446756,25.262732552755285,-0.12,29,49,25,4.53421902118034,Aleatória
1,24,26,5,5,36,1.263157894736842,1.4444444444444444,5,1,32,0,19,18,17,0.9988455357066628,4.484685050257153,0.74,5,8,18,18,0.9434164716336324,0.90856192113853,1.11665284679121,1.019173385673773,2.933044035175586,6.770069625611477,10.132917326876631,47.21355072497972,-0.04,24,49,21,3.6516598775783047,Humana
1,22,28,6,4,24,1.8333333333333333,2.1538461538461537,0,0,10,2,12,13,18,0.9895875209335165,1.9313207915827966,0.5,10,15,12,12,0.8365012677171205,1.3437096247164249,0.9483713850721502,1.1661903789690602,1.6645450910890562,4.189440123192778,6.1851211072664345,19.432505085208692,-0.12,29,47,26,4.53421902118034,Aleatória
-1,25,25,3,4,32,1.5625,1.4705882352941178,2,0,21,1,16,17,18,0.9999999997114609,3.140764238207001,0.66,9,8,16,16,1.0,0.6091746465505602,0.9150793638884732,0.7832029080800051,1.463661159142039,5.687250235308675,4.399530280755854,35.78426999902546,0.0,28,49,22,4.176297424512728,Humana
0,30,20,9,4,26,2.142857142857143,1.5384615384615385,2,0,18,5,14,13,18,0.9709505941661296,2.6016148831062607,0.54,16,7,13,13,0.7369655941662062,2.3255457994428155,0.8426500884694864,1.799253007628314,2.778285570725194,6.1388573379530165,10.387861964952599,40.747247684106256,0.2,26,41,22,4.14039558854744,Humana
1,23,27,4,4,25,1.7692307692307692,2.076923076923077,1,0,9,0,13,13,18,0.9953784385316868,2.1188676221038443,0.52,10,14,13,12,0.8889686876112561,0.890448992522325,0.8284868934053083,0.8736782070461959,0.8415472616275143,4.488195952893602,3.1543176491797356,22.41043299436247,-0.08,30,47,27,4.53421902118034,Aleatória
-1,25,25,4,3,30,1.5625,1.6666666666666667,1,0,17,1,16,15,18,0.9999999997114609,2.756011611006021,0.62,9,10,15,15,1.0,0.8637671850678283,0.6992058987801011,0.7901579815429607,1.1949427461877273,4.989779428608139,3.8230999999999993,27.652303196142075,0.0,30,49,25,4.484987227560983,Aleatória
1,23,27,3,5,39,1.15,1.35,6,1,34,2,20,20,15,0.9953784385316868,4.77912125813941,0.8,3,7,19,20,0.8889686876112561,0.47696960070847283,0.9096702699330126,0.733143914930759,3.7588990338256334,6.706711843158966,18.044889129259058,46.583739468348995,-0.08,22,50,17,3.409249326357417,Humana
1,24,26,7,3,23,2.0,2.1666666666666665,1,0,11,4,12,12,18,0.9988455357066628,1.9518196638009364,0.48,12,14,11,12,0.9434164716336324,1.6832508230603465,0.8975274678557507,1.3514395616855712,1.8742629541177904,4.379385044188632,7.559181136058059,21.500538968641017,-0.04,29,50,22,4.224117662343592,Aleatória
0,26,24,5,4,25,2.0,1.8461538461538463,0,0,10,1,13,13,18,0.9988455357066628,2.090358820872627,0.52,13,11,12,13,0.9434164716336324,1.1094003924504583,0.8634593969478326,0.9970370305242862,1.3184670170868025,4.4058107552442936,4.652423469387753,21.13884900449309,0.04,28,50,26,4.4992268369534525,Aleatória
1,24,26,6,10,28,1.7142857142857142,1.7333333333333334,2,2,22,4,14,15,18,0.9988455357066628,3.1182687504447086,0.58,10,11,14,14,0.9434164716336324,1.4356965173029843,2.235073948565361,1.89184368611658,3.3026352540292168,6.5033190702326005,13.615785918477714,44.56013792494444,-0.04,28,49,22,4.240528260216711,Humana
0,26,24,4,4,30,1.7333333333333334,1.5,1,0,20,0,15,16,18,0.9988455357066628,2.918150098949676,0.62,11,8,15,15,0.9434164716336324,0.9285592184789414,0.9354143466934853,0.9393690179716797,1.306221211889421,5.950255617900168,3.4253404236383074,39.04619952281565,0.04,30,49,27,4.553362162946345,Humana
1,24,26,3,4,30,1.5,1.7333333333333334,2,0,17,1,16,15,18,0.9988455357066628,2.756011611006021,0.62,8,11,15,15,0.9434164716336324,0.7071067811865476,0.8537498983243799,0.7901579815429607,1.1949427461877278,4.989779428608139,3.8231000000000006,27.652303196142075,-0.04,29,47,25,4.501397825434102,Aleatória
1,17,33,3,7,24,1.3076923076923077,2.75,2,2,14,4,13,12,17,0.924818704684491,2.090454496036687,0.5,4,21,12,12,0.5994620704162712,0.6056929133855239,1.8314384146529925,1.5231546211727816,1.7658451315617862,5.589315887271402,5.603448275862069,35.228885316464975,-0.32,27,49,22,4.213460597220265,Aleatória
1,24,26,5,5,26,1.8461538461538463,1.8571428571428572,1,1,15,0,13,14,18,0.9988455357066628,2.2996521476084157,0.54,11,12,13,13,0.9434164716336324,1.166596222161777,1.1866605518454392,1.1770554505237556,1.3788891329133408,5.257199436711657,4.1106264091755715,31.83668319478608,-0.04,29,47,29,4.735199727655046,Aleatória
0,26,24,4,3,27,1.8571428571428572,1.7142857142857142,3,0,16,1,14,14,17,0.9988455357066628,2.5072694310743713,0.56,12,10,14,13,0.9434164716336324,0.989743318610787,0.9583148474999098,0.9767710236555245,0.6687036605654509,5.2014211369476415,1.8651090966284423,30.332650991857818,0.04,25,46,18,3.9531525874151106,Humana
-1,25,25,2,3,40,1.25,1.1904761904761905,5,0,33,1,20,21,15,0.9999999997114609,4.7018719676316145,0.82,5,4,20,20,1.0,0.4330127018922193,0.49943278484292924,0.4691557088212523,2.036786905463754,6.452165626553264,6.405741417092768,43.9430187541438,0.0,23,49,15,3.493125207877498,Humana
0,26,24,3,5,31,1.625,1.5,2,1,18,2,16,16,17,0.9988455357066628,2.9983995731056265,0.64,10,8,15,16,0.9434164716336324,0.5994789404140899,1.0,0.8267972847076845,2.288520889146155,4.960389617690103,9.772832653061224,26.59626057080567,0.04,26,50,23,4.311074184082723,Aleatória
0,26,24,3,5,36,1.368421052631579,1.3333333333333333,5,1,31,2,19,18,17,0.9988455357066628,4.362613895361358,0.74,7,6,18,18,0.9434164716336324,0.7405919620773836,1.0,0.8766094454176677,2.624999754103427,6.678021018357878,9.49376527056919,46.30034477005315,0.04,22,49,19,3.6249106447493045,Humana
1,24,26,6,5,22,2.1818181818181817,2.1666666666666665,0,1,9,1,11,12,18,0.9988455357066628,1.69952934661335,0.46,13,14,11,11,0.9434164716336324,1.526623238522424,1.21335164821342,1.3721507685269128,1.300661759961987,4.297619348631691,3.904618473895587,20.53137029875299,-0.04,33,48,30,4.827909782143969,Aleatória
1,24,26,5,4,27,1.7142857142857142,1.8571428571428572,1,0,16,1,14,14,18,0.9988455357066628,2.4507957891264627,0.56,10,12,14,13,0.9434164716336324,1.097306535409801,1.1866605518454392,1.1450871101343856,1.4242637476988298,5.373040850978042,3.887553180214688,32.48151018597387,-0.04,26,47,26,4.528465488430547,Aleatória
0,26,24,5,5,23,2.1666666666666665,2.0,1,1,9,0,12,12,17,0.9988455357066628,1.802664694279,0.48,14,12,12,11,0.9434164716336324,1.1426091000668408,1.1547005383792515,1.1516895800904376,1.146354322311449,3.873373085996618,3.805076615224364,16.842005778963717,0.04,29,46,25,4.452166031814745,Aleatória
0,27,23,4,3,36,1.4210526315789473,1.2777777777777777,4,0,29,1,19,18,17,0.9953784385316868,4.107602707176048,0.74,8,5,18,18,0.8889686876112561,0.9355994123490092,0.558326423395605,0.778641096804753,2.3902574968384127,6.530514263116234,7.878075192335614,44.833247584299464,0.08,27,46,19,3.697186554571255,Humana
1,23,27,4,9,30,1.5333333333333334,1.6875,2,1,21,5,15,16,18,0.9953784385316868,3.1233955881380124,0.62,8,11,15,15,0.8889686876112561,0.8055363982396382,1.9273929931386593,1.4957449186283396,3.9748464227021456,5.812693797545335,19.420769280692266,36.877374781006594,-0.08,27,48,21,4.047685534058519,Humana
0,30,20,7,6,13,4.285714285714286,2.857142857142857,1,3,6,1,7,7,17,0.9709505941661296,1.1142710621747296,0.28,23,13,7,6,0.7369655941662062,2.1852940772540506,2.166535841157586,2.290174220268771,-0.10995083123850911,4.289985038503516,1.274674862602007,20.44829418641725,0.2,23,42,18,3.857709989033302,Humana
0,26,24,5,6,25,2.0,1.8461538461538463,3,1,16,1,13,13,18,0.9988455357066628,2.308592644881292,0.52,13,11,13,12,0.9434164716336324,1.3008872711759818,1.5112986695683457,1.4121199808219862,1.4475072208735789,6.074932800606009,4.050533156054908,40.4909284893301,0.04,28,46,28,4.6917214667854825,Humana
0,26,24,4,4,29,1.7333333333333334,1.6,4,0,21,0,15,15,18,0.9988455357066628,3.006659275674582,0.6,11,9,15,14,0.9434164716336324,0.9977753031397177,1.2,1.1055415967851332,1.277311696120344,6.28074852020713,2.9504132231404947,42.42838123580542,0.04,25,46,19,4.042280097634891,Humana
0,26,24,2,2,42,1.1818181818181819,1.1428571428571428,5,0,36,0,22,21,15,0.9988455357066628,5.114723843962645,0.86,4,3,21,21,0.9434164716336324,0.38569460791993493,0.34992710611188255,0.3691746015438964,1.826828286211264,6.515912705720975,4.337301587301583,44.602618566967024,0.04,23,49,14,2.9982668963438797,Humana
0,28,22,3,3,36,1.4736842105263157,1.2222222222222223,3,0,27,0,19,18,17,0.9895875209335165,3.897742936623707,0.74,9,4,18,18,0.8365012677171205,0.6781104593013224,0.5328701692569688,0.6245524328806131,1.5734316351820388,6.196420149108264,4.23012666750831,41.342137492401264,0.12,29,49,20,3.9872351199035974,Humana
-1,25,25,1,1,49,1.0,1.0,8,0,50,0,25,25,14,0.9999999997114609,7.0,1.0,0,0,25,24,1.0,0.0,0.0,0.0,0.0,6.857142857142857,0.0,48.02040816326531,0.0,13,48,2,1.0,Humana
0,26,24,4,3,38,1.368421052631579,1.2,5,0,33,1,19,20,17,0.9988455357066628,4.631587200949585,0.78,7,4,19,19,0.9434164716336324,0.8085416576703799,0.6000000000000001,0.7142763219068778,2.482969472013432,6.731306931490558,8.022764108831977,46.841446972111044,0.04,22,49,17,3.2146177675424816,Humana
0,27,23,5,4,27,1.9285714285714286,1.6428571428571428,3,0,18,1,14,14,17,0.9953784385316868,2.6165626306282066,0.56,13,9,14,13,0.8889686876112561,1.2797480619406367,1.0424656799518874,1.175862688082452,1.2117753255651786,6.017764040583895,3.2236625318282703,39.643598051998374,0.08,25,47,21,4.172714880243586,Humana
-1,25,25,4,5,27,1.7857142857142858,1.7857142857142858,1,1,16,1,14,14,18,0.9999999997114609,2.4179330015531866,0.56,11,11,14,13,1.0,1.0126747770541304,1.1450871101343856,1.0809104250301114,1.2812378104893436,5.444349467554888,3.865849240098394,33.711292391180265,0.0,29,43,26,4.528465488430549,Aleatória
1,24,26,3,3,33,1.411764705882353,1.5294117647058822,2,0,22,0,17,17,18,0.9988455357066628,3.289012009707475,0.68,7,9,16,17,0.9434164716336324,0.6910200073218078,0.6960093862470137,0.6960093862470137,1.1518245128728637,5.680216849180987,2.956938775510203,35.824742451623514,-0.04,29,50,22,4.354552444952288,Humana
1,24,26,3,3,34,1.3333333333333333,1.5294117647058822,3,0,24,0,18,17,17,0.9988455357066628,3.5114099732158874,0.7,6,9,17,17,0.9434164716336324,0.6666666666666666,0.6960093862470137,0.6880911187881312,1.3101140356236558,5.967892647512502,3.3070749108204494,38.99715448839004,-0.04,31,48,21,4.1678113478700505,Aleatória
1,24,26,3,4,26,1.7142857142857142,2.0,0,0,12,1,14,13,18,0.9988455357066628,2.1467184258770406,0.54,10,13,13,13,0.9434164716336324,0.6998542122237651,1.1094003924504583,0.9310966733315952,0.8484265973646229,4.342181412702237,2.752804037814452,21.210044400190004,-0.04,32,48,25,4.501397825434101,Humana
0,29,21,5,4,29,1.9333333333333333,1.4,2,0,20,1,15,15,18,0.9814538947451146,2.891366458960192,0.6,14,6,15,14,0.7858751946471527,1.18133634311129,1.019803902718557,1.1352924243950933,1.6351045767521486,6.115219209977728,4.405469678953625,40.65289256198342,0.16,26,47,21,4.240528260216711,Humana
1,23,27,3,4,27,1.6428571428571428,1.9285714285714286,1,0,13,1,14,14,18,0.9953784385316868,2.3078994778802655,0.56,9,13,13,14,0.8889686876112561,0.8112726208286106,0.9609731462195508,0.9006800152084637,1.0204927952071208,4.516143682702579,3.2332977334757325,22.512213639822463,-0.08,30,50,26,4.517808423307221,Aleatória
1,24,26,3,7,34,1.3333333333333333,1.5294117647058822,3,1,27,4,18,17,16,0.9988455357066628,3.8327535793473606,0.7,6,9,17,17,0.9434164716336324,0.6666666666666666,1.4190985978605668,1.1028719466067876,3.823365585811063,6.485392015849818,18.871334624566465,44.37437423567894,-0.04,26,49,23,4.158067523162808,Humana
0,26,24,4,4,27,1.8571428571428572,1.7142857142857142,1,0,15,0,14,14,18,0.9988455357066628,2.350829640786418,0.56,12,10,13,14,0.9434164716336324,1.0594569267279519,0.9583148474999098,1.0126747770541304,1.0569656691373621,5.078658933855018,2.8653003638523797,29.647524131366367,0.04,33,50,29,4.768020923401285,Aleatória
0,27,23,3,2,40,1.2857142857142858,1.15,4,0,33,1,21,20,15,0.9953784385316868,4.7018719676316145,0.82,6,3,20,20,0.8889686876112561,0.5471012044321932,0.3570714214271425,0.4691557088212523,2.036786905463754,6.452165626553264,6.405741417092768,43.9430187541438,0.08,26,49,15,3.5573560435814815,Humana
1,22,28,4,7,23,1.8333333333333333,2.3333333333333335,1,1,12,3,12,12,18,0.9895875209335165,1.9312172327317298,0.48,10,16,12,11,0.8365012677171205,1.1426091000668408,1.7480147469502527,1.4976833963009524,1.643749481065132,4.820267296297683,5.429180764696294,26.88233683214378,-0.12,30,47,25,4.51205489055743,Aleatória
0,28,22,3,3,36,1.4736842105263157,1.2222222222222223,3,0,27,0,19,18,18,0.9895875209335165,3.897742936623707,0.74,9,4,18,18,0.8365012677171205,0.6781104593013224,0.5328701692569688,0.6245524328806131,1.5734316351820388,6.196420149108264,4.230126667508309,41.342137492401264,0.12,27,49,17,3.708693620070838,Humana
1,23,27,3,4,24,1.7692307692307692,2.25,1,0,12,1,13,12,17,0.9953784385316868,2.0420577856662137,0.5,10,15,12,12,0.8889686876112561,0.890448992522325,1.1636866703140785,1.0583005244258363,0.40496193536702907,4.594039909095013,1.6581632653061222,23.80958542518503,-0.08,30,49,22,4.300417118959396,Aleatória
1,22,28,4,5,26,1.6923076923076923,2.0,1,1,13,1,13,14,17,0.9895875209335165,2.210972636646596,0.54,9,14,13,13,0.8365012677171205,0.910166120476864,1.1952286093343936,1.0785347984119287,1.359351241341271,4.698627920888068,4.1368814524741895,24.471004050066927,-0.12,32,49,27,4.604764945046351,Aleatória
0,27,23,5,4,22,2.25,2.090909090909091,0,0,11,1,12,11,18,0.9953784385316868,1.7459667808981936,0.46,15,12,11,11,0.8889686876112561,1.3616778865306827,1.2398346997259868,1.3072431633367745,0.6105915368653501,4.779018386492186,1.950700916281621,27.331325567249955,0.08,29,48,23,4.348798912202496,Aleatória
0,26,24,2,1,48,1.04,1.0,7,0,48,1,25,24,14,0.9988455357066628,6.718601044860455,0.98,1,0,24,24,0.9434164716336324,0.19595917942265428,0.0,0.14139190265868387,6.783865662978103,6.8525550493093474,47.020833333333314,47.97875959615328,0.04,15,49,6,1.5116911406707563,Humana
-1,25,25,18,18,13,3.5714285714285716,3.5714285714285716,1,3,10,0,7,7,17,0.9999999997114609,1.4427751037497147,0.28,18,18,6,7,1.0,5.900536122303824,5.900536122303824,5.900536122303825,2.026986685307832,6.176413770439726,5.134229373193569,41.282438684604315,0.0,21,50,17,3.0591961882357865,Humana
0,27,23,3,5,31,1.6875,1.4375,2,1,22,2,16,16,18,0.9953784385316868,3.1607594024221464,0.64,11,7,15,16,0.8889686876112561,0.7680128579652817,1.1709371246996996,0.998044963916957,1.9022483759786541,6.225883616542337,5.9880507497116495,41.792937158172776,0.08,23,50,18,3.9793105986731567,Humana
0,28,22,4,3,27,2.0,1.5714285714285714,1,0,14,1,14,14,18,0.9895875209335165,2.3078994778802655,0.56,14,8,14,13,0.8365012677171205,1.0,0.7284313590846836,0.9006800152084637,0.7272133408660711,4.633285464433156,2.3029547881808465,24.834848565375886,0.12,28,48,21,4.178468412993377,Humana
0,28,22,4,4,26,2.0,1.6923076923076923,0,0,12,0,14,13,17,0.9895875209335165,2.201908263302538,0.54,14,9,13,13,0.8365012677171205,1.0690449676496976,0.8213137116947162,0.9700593224969477,1.029751665527629,4.425750655288532,3.0817644008873857,21.527061205255784,0.12,27,49,22,4.265424934732508,Aleatória
1,19,31,3,12,20,1.7272727272727273,3.1,0,3,9,9,11,10,17,0.9580420219377606,1.5885842753848471,0.42,8,21,10,10,0.6896598793878495,0.7496555682941201,3.207802986469088,2.3799998094475807,3.1256540345844814,4.232073384330977,12.825246586380395,20.584683460222987,-0.24,29,49,24,4.245431792590247,Aleatória
-1,25,25,4,6,25,1.9230769230769231,1.9230769230769231,0,1,12,2,13,13,17,0.9999999997114609,2.0614557962760203,0.52,12,12,13,12,1.0,0.9166442529086912,1.3846153846153846,1.1741798094210576,1.7173750407498691,4.491825054851136,6.251745289100922,22.868487126215726,0.0,32,48,27,4.604764945046352,Aleatória
-1,25,25,5,7,24,1.9230769230769231,2.0833333333333335,1,1,12,2,13,12,18,0.9999999997114609,2.0124611797498106,0.5,12,13,12,12,1.0,1.071414482860317,1.7539637649874324,1.4422205101855958,2.000120899850586,4.762916811332885,6.804733727810651,25.19387288523091,0.0,29,49,29,4.708132064658601,Aleatória
1,23,27,4,6,22,2.090909090909091,2.25,1,2,11,2,11,12,18,0.9953784385316868,1.722904524342542,0.46,12,15,11,11,0.8889686876112561,1.1642044068059725,1.6393596310755,1.4341236958670123,1.1084635987988662,4.924705389801575,3.320772058823532,28.742747544040242,-0.08,30,48,26,4.604764945046351,Aleatória
1,24,26,5,5,19,2.4,2.6,1,2,6,0,10,10,17,0.9988455357066628,1.3266499161421597,0.4,14,16,10,9,0.9434164716336324,1.3564659966250538,1.3564659966250536,1.3601470508735443,0.596119963859844,3.2994934639589375,2.2388604821037252,12.434917355371905,-0.04,29,47,20,4.159886826639609,Aleatória
0,27,23,5,4,15,3.375,2.875,0,0,3,1,8,8,17,0.9953784385316868,1.0665833300778709,0.32,19,15,8,7,0.8889686876112561,1.4947825928876748,1.0532687216470449,1.3169567191065923,-0.39505494958347254,3.7871629722732085,1.9242756269783297,17.933848445465152,0.08,29,45,19,3.9594676755771387,Humana
0,26,24,4,5,24,2.0,2.0,0,1,11,1,13,12,18,0.9988455357066628,1.9313207915827966,0.5,13,12,12,12,0.9434164716336324,0.8770580193070292,1.4142135623730951,1.1661903789690602,1.0592559670566721,4.42264951374824,3.0709342560553625,22.089032480647454,0.04,32,48,24,4.468576629687865,Aleatória
-1,25,25,3,4,32,1.4705882352941178,1.5625,4,0,22,1,17,16,18,0.9999999997114609,3.210046728631844,0.66,8,9,16,16,1.0,0.6960093862470137,0.9333240326917549,0.820982859645095,1.430062307548088,5.982591210754329,3.965479734796458,39.240946958082624,0.0,30,49,24,4.395859717341203,Humana
1,20,30,4,6,22,1.8181818181818181,2.5,1,2,8,2,11,12,18,0.9709505941661296,1.8023318229449317,0.46,9,18,11,11,0.7369655941662062,0.8331955809010617,1.707825127659933,1.4034793383973017,1.6708989733145696,4.440858722860525,5.108224254994646,21.850744058727177,-0.2,28,48,26,4.43716698973012,Aleatória
1,20,30,3,14,28,1.3333333333333333,2.142857142857143,4,2,23,11,15,14,16,0.9709505941661296,3.2378387853628547,0.58,5,16,14,14,0.7369655941662062,0.5962847939999438,3.3775972621533965,2.4196972128067356,4.515362578821256,6.643355258171503,22.87970226236522,45.98534037303694,-0.2,25,49,17,3.493125207877498,Humana
1,24,26,5,3,28,1.7142857142857142,1.7333333333333334,2,0,15,2,14,15,17,0.9988455357066628,2.4745908752761534,0.58,10,11,14,14,0.9434164716336324,1.1605769149479945,0.679869268479038,0.9430892642191272,1.5603085413193862,4.786371479760106,5.663966656181189,25.81752240638203,-0.04,32,48,25,4.484987227560983,Aleatória
0,31,19,7,4,32,1.8235294117647058,1.1875,4,0,26,3,17,16,17,0.9580420219377606,3.6584696254034967,0.66,14,3,16,16,0.6896598793878495,1.5043190414758145,0.7261843774138906,1.2338953376668078,3.0138636168815456,6.646828302374218,12.54568848482556,46.03653408687962,0.24,24,43,18,3.785404413052635,Humana
0,28,22,4,4,26,2.0,1.6923076923076923,1,0,16,0,14,13,18,0.9895875209335165,2.3766362784406034,0.54,14,9,13,13,0.8365012677171205,1.1338934190276817,1.1357556200179537,1.1451573950918745,0.8835269912947115,5.6399763946311845,2.165573957038567,36.01614572898261,0.12,29,49,23,4.3523814564716385,Aleatória
1,22,28,4,9,19,2.2,2.8,1,1,6,5,10,10,16,0.9895875209335165,1.3711309200802086,0.4,12,18,10,9,0.8365012677171205,0.9797958971132712,2.2715633383201097,1.7748239349298849,2.3342355606787604,3.491449264577264,9.202569916855632,13.708012675418747,-0.12,30,45,25,4.482816239080333,Aleatória
1,23,27,4,7,25,1.7692307692307692,2.076923076923077,1,1,13,3,13,13,18,0.9953784385316868,2.1094074997496337,0.52,10,14,12,13,0.8889686876112561,0.9730085108210399,1.5913969896597848,1.327898192433236,2.21080604311812,4.798414862436959,8.631548128462684,26.437212057314497,-0.08,31,50,28,4.642489673166125,Aleatória
1,24,26,4,5,22,2.0,2.3636363636363638,0,1,7,1,12,11,18,0.9988455357066628,1.675828153481138,0.46,12,15,11,11,0.9434164716336324,1.0,1.1499191491521379,1.0895620944471014,0.8616288338679113,4.021564028964814,3.1218406426224212,18.544670726664698,-0.04,30,48,25,4.403784238571644,Aleatória
1,20,30,5,6,25,1.5384615384615385,2.3076923076923075,2,1,16,1,13,13,17,0.9709505941661296,2.325854681617061,0.52,7,17,12,13,0.7369655941662062,1.1512791959304434,1.5876744185038687,1.4390989949130544,1.4509994625199676,5.9784417316479965,3.897959183673468,39.37332061021622,-0.2,28,50,23,4.311074184082722,Aleatória
1,22,28,4,6,27,1.5714285714285714,2.0,1,1,14,2,14,14,18,0.9895875209335165,2.392989761783364,0.56,8,14,13,14,0.8365012677171205,0.9035079029052513,1.2535663410560174,1.1134612334371357,2.1367503789761457,4.764139255741269,8.11294010059442,24.74930224202978,-0.12,31,50,27,4.615422010169679,Aleatória
-1,25,25,4,7,23,2.0833333333333335,2.0833333333333335,1,1,12,3,12,12,18,0.9999999997114609,1.889338508579127,0.48,13,13,11,12,1.0,1.114924013354971,1.7057907908715597,1.4409680388158819,1.692393195553378,4.93301935630747,6.10218006509994,28.552362788232568,0.0,33,50,24,4.430851901568091,Humana
1,23,27,3,4,33,1.3529411764705883,1.588235294117647,3,0,24,1,17,17,17,0.9953784385316868,3.455083211733113,0.68,6,10,17,16,0.8889686876112561,0.6809315825170721,0.9737026680733442,0.8483650059915269,1.826110381563585,6.21773229538571,5.363258136094674,41.62058083349597,-0.08,30,47,21,4.24901433685939,Humana
0,28,22,6,5,25,2.1538461538461537,1.6923076923076923,0,1,16,1,13,13,18,0.9895875209335165,2.342989543297195,0.52,15,9,12,13,0.8365012677171205,1.5112986695683461,1.2015768732164083,1.3846153846153846,1.4418724279835389,5.903838506373139,4.215534979423866,38.382189971406994,0.12,29,50,24,4.3794491194680845,Aleatória
-1,25,25,4,3,32,1.5625,1.4705882352941178,2,0,22,1,16,17,17,0.9999999997114609,3.210046728631844,0.66,9,8,16,16,1.0,0.8637671850678283,0.7759356446042893,0.820982859645095,1.430062307548088,5.982591210754329,3.9654797347964577,39.240946958082624,0.0,30,47,22,4.300417118959396,Humana
0,27,23,7,5,26,2.076923076923077,1.6428571428571428,1,1,16,2,13,14,18,0.9953784385316868,2.3850366873488547,0.54,14,9,13,13,0.8889686876112561,1.6390212117432705,1.1715156762040515,1.4325244152454604,2.150787534086903,5.681955142933588,7.333615130544198,35.86370287993179,0.08,30,48,24,4.414441303694972,Aleatória
0,27,23,3,3,39,1.35,1.15,4,0,33,0,20,20,16,0.9953784385316868,4.651881339845205,0.8,7,3,20,19,0.8889686876112561,0.653834841531101,0.47696960070847283,0.5809475019311126,2.1994720237721133,6.636871170588997,6.481481481481481,45.91964972102723,0.08,23,48,17,3.704201424063296,Humana
0,27,23,4,4,35,1.5,1.2777777777777777,4,0,27,0,18,18,17,0.9953784385316868,3.8576676891614197,0.72,9,5,17,18,0.8889686876112561,0.8333333333333334,0.7307192465536614,0.7915448249319448,2.2162256279125394,6.369160959405699,7.158169331942054,43.14723222723248,0.08,29,50,23,4.063534576519399,Humana
0,27,23,6,5,25,2.076923076923077,1.7692307692307692,2,1,14,1,13,13,18,0.9953784385316868,2.193080025899648,0.52,14,10,12,13,0.8889686876112561,1.5913969896597846,1.1200169060431566,1.3846153846153846,1.7026748971193406,5.16090762738616,4.90134887974394,30.08336752974423,0.08,29,50,30,4.79508858639773,Aleatória
1,22,28,6,5,22,1.8333333333333333,2.5454545454545454,2,3,14,1,12,11,18,0.9895875209335165,2.0318464508914054,0.46,10,17,11,11,0.8365012677171205,1.4624940645653537,1.776801844153824,1.6590246981164272,1.0364412339993392,5.9875806016668305,2.552671401400798,39.540679063039526,-0.12,28,48,23,4.333238314705633,Humana
-1,25,25,6,5,26,1.7857142857142858,1.9230769230769231,2,1,17,1,14,13,17,0.9999999997114609,2.45120378589786,0.54,11,12,13,13,1.0,1.3190132366156706,1.4390989949130544,1.379847111866456,1.6203081813053837,6.111493203786268,4.5906597513474905,40.7525737052475,0.0,24,48,19,4.023136955868885,Humana
0,28,22,8,7,23,2.3333333333333335,1.8333333333333333,0,1,14,1,12,12,18,0.9895875209335165,2.080769088582392,0.48,16,10,12,11,0.8365012677171205,2.0548046676563256,1.674979270186815,1.8911342863183693,2.06088538050022,5.689351225486098,6.198951833349044,36.1022536762356,0.12,30,48,28,4.613251021689028,Aleatória
0,26,24,5,6,19,2.6,2.4,0,1,5,1,10,10,18,0.9988455357066628,1.3564659966250534,0.4,16,14,10,9,0.9434164716336324,1.2,1.42828568570857,1.3228756555322954,0.9719086448808701,3.5770700667144624,3.5959183673469384,14.273156899810973,0.04,30,45,26,4.544876086303668,Aleatória
0,26,24,3,4,41,1.2380952380952381,1.1428571428571428,6,0,38,1,21,21,16,0.9988455357066628,5.319248067161372,0.84,5,3,20,21,0.9434164716336324,0.6098213559459856,0.6388765649999399,0.6263307827602812,3.3232844720471166,6.815360738570385,13.031541314444187,47.6362392768654,0.04,18,50,12,2.567040216926578,Humana
1,24,26,4,6,27,1.7142857142857142,1.8571428571428572,3,1,17,2,14,14,18,0.9988455357066628,2.49927989629013,0.56,10,12,14,13,0.9434164716336324,1.097306535409801,1.3552618543578767,1.2351154618421845,1.7767227307832383,5.816892719525646,5.778246328340845,37.665472492483524,-0.04,27,48,27,4.664653803789036,Aleatória
0,32,18,5,3,29,2.1333333333333333,1.2,1,0,18,2,15,15,16,0.9426831889669534,2.7422618401604177,0.6,17,3,15,14,0.6438561897747247,1.2036980056845192,0.5416025603090641,1.0434983894999017,1.7536509794386104,5.495541142444607,5.329029571012079,33.48234495246715,0.28,30,48,21,3.9814815871538056,Aleatória
1,24,26,8,7,19,2.4,2.6,2,1,7,1,10,10,18,0.9988455357066628,1.3856406460551016,0.4,14,16,9,10,0.9434164716336324,2.0591260281974,1.6852299546352718,1.8841443681416772,1.7716414015059614,3.8159244354251833,5.420551477881373,16.54947916666667,-0.04,27,50,23,4.354552444952288,Aleatória
-1,25,25,5,4,25,1.9230769230769231,1.9230769230769231,1,0,12,1,13,13,18,0.9999999997114609,2.09990475974507,0.52,12,12,13,12,1.0,1.3846153846153846,0.9166442529086912,1.1741798094210576,1.43227053987882,4.585486835373792,4.234541067251192,23.19696621805231,0.0,30,44,26,4.561286684176786,Aleatória
1,19,31,5,10,19,1.9,3.1,0,2,9,5,10,10,18,0.9580420219377606,1.4422205101855956,0.4,9,21,10,9,0.6896598793878495,1.57797338380595,2.4677925358506134,2.1563858652847827,2.1242233289659316,4.680282905650373,7.61533125216788,26.31139053254438,-0.24,26,46,23,4.276081999855835,Aleatória
0,29,21,2,3,38,1.45,1.105263157894737,1,0,29,1,20,19,17,0.9814538947451146,4.225115383039852,0.78,9,2,19,19,0.7858751946471527,0.4974937185533099,0.44659375653887207,0.5037662231894486,1.554387052802302,6.100527389522975,4.492912561411046,40.089511308225056,0.16,23,49,12,3.000972825245974,Humana
1,24,26,4,4,26,1.8461538461538463,1.8571428571428572,2,0,14,0,13,14,18,0.9988455357066628,2.201908263302538,0.54,11,12,13,13,0.9434164716336324,0.9483713850721502,1.1248582677159729,1.0436298373041015,0.8848926060877839,4.965292111289962,2.441748250417171,28.83886311608344,-0.04,28,46,22,4.32173124920605,Humana
1,23,27,6,5,23,1.9166666666666667,2.25,2,1,13,1,12,12,18,0.9953784385316868,1.9415457759218555,0.48,11,15,11,12,0.8889686876112561,1.4976833963009524,1.3616778865306827,1.4409680388158819,1.191057976939166,5.522886616759028,3.4348273509244858,34.86637483749904,-0.08,29,50,23,4.381620107948734,Aleatória
1,23,27,7,10,19,2.3,2.7,0,2,7,3,10,10,17,0.9953784385316868,1.4966629547095762,0.4,13,17,10,9,0.8889686876112561,1.676305461424021,2.6095976701399777,2.202271554554524,2.3031514610284325,4.345381442165402,7.684663619938357,20.89349489795919,-0.08,30,39,27,4.51205489055743,Aleatória
0,32,18,10,4,18,3.2,2.0,1,0,10,6,10,9,17,0.9426831889669534,1.5217095649301808,0.38,22,9,9,9,0.6438561897747247,2.749545416973504,1.4142135623730951,2.298982070299111,1.75401089100936,5.33686197402949,5.956815394960641,32.616314869299096,0.28,27,49,21,4.137161140604462,Humana
1,24,26,4,3,30,1.6,1.625,2,0,19,1,15,16,16,0.9988455357066628,2.841760018017004,0.62,9,10,15,15,0.9434164716336324,1.019803902718557,0.7806247497997998,0.9043771463791087,1.3624944200504339,5.642142279006842,3.8038867198881214,35.52070002471883,-0.04,28,49,23,4.381620107948734,Aleatória
0,26,24,4,7,30,1.625,1.6,3,1,23,3,16,15,18,0.9988455357066628,3.2489382881181355,0.62,10,9,15,15,0.9434164716336324,1.0532687216470449,1.540562667772179,1.311916090816952,2.625232471351543,6.541815796456293,9.995220995161775,45.038520804956505,0.04,26,49,25,4.104339944858223,Humana
0,26,24,7,6,27,1.8571428571428572,1.7142857142857142,2,1,17,1,14,14,18,0.9988455357066628,2.5624987804875152,0.56,12,10,14,13,0.9434164716336324,1.5518257844571735,1.3324827218698305,1.448081066622378,2.493681647823046,5.593167688216496,8.654110501358623,34.68498391242889,0.04,28,43,27,4.599011412296559,Humana
1,23,27,4,7,21,2.090909090909091,2.4545454545454546,0,2,11,3,11,11,18,0.9953784385316868,1.7338973441354597,0.44,12,16,10,11,0.8889686876112561,1.311109554714178,2.18938083250769,1.813630667569091,1.557038176906665,4.946750793413333,4.43092346152875,28.585270210140294,-0.08,26,50,23,4.278252988336485,Aleatória
0,32,18,6,4,29,2.1333333333333333,1.2,0,0,20,2,15,15,18,0.9426831889669534,2.90516780926679,0.6,17,3,14,15,0.6438561897747247,1.4544949486180951,0.7483314773547879,1.247219128924647,2.1953602014234863,6.07644092448335,7.065306122448981,40.01004020574555,0.28,25,50,18,3.858271544445539,Humana
1,18,32,3,8,23,1.5,2.6666666666666665,2,2,12,5,12,12,17,0.9426831889669534,1.9208331525668751,0.48,6,20,11,12,0.6438561897747247,0.7637626158259734,1.9720265943665387,1.6051133570215184,2.221953332171751,4.822332839581472,8.272803888376284,27.105247895869528,-0.28,31,50,24,4.455748576083888,Aleatória
1,24,26,3,3,37,1.263157894736842,1.368421052631579,5,0,29,0,19,19,18,0.9988455357066628,4.1403381504413375,0.76,5,7,19,18,0.9434164716336324,0.6359497880839249,0.581334790378277,0.6115236862432762,1.7653153721231833,6.3841384703414965,4.843950617283951,43.33989853941377,-0.04,27,48,19,3.8896215330411397,Humana
-1,25,25,4,4,27,1.7857142857142858,1.7857142857142858,1,0,14,0,14,14,18,0.9999999997114609,2.2992172581119865,0.56,11,11,14,13,1.0,0.9394961741404219,0.9394961741404219,0.939496174140422,0.9545323820796531,4.730992103558808,2.848107187009254,25.65042885870232,0.0,34,48,30,4.81149918427085,Aleatória
1,23,27,3,5,41,1.0952380952380953,1.2857142857142858,6,1,38,2,21,21,15,0.9953784385316868,5.319248067161372,0.84,2,6,21,20,0.8889686876112561,0.42591770999996,0.8806305718527109,0.6982322999340561,4.33716679236269,6.815360738570386,22.262693347755544,47.63623927686542,-0.08,22,48,15,2.9699975479673286,Humana
-1,25,25,5,5,31,1.5625,1.5625,3,1,22,0,16,16,18,0.9999999997114609,3.217203754815663,0.64,9,9,15,16,1.0,0.998044963916957,1.1709371246996996,1.0879309490955758,2.242197850581843,6.002072519306132,7.071692317746626,39.16913937575118,0.0,28,50,25,4.354552444952287,Humana
0,27,23,3,3,33,1.588235294117647,1.3529411764705883,0,0,21,0,17,17,17,0.9953784385316868,3.2461669704437575,0.68,10,6,17,16,0.8889686876112561,0.6910200073218077,0.5882352941176471,0.6523845003770246,1.0622108135228525,5.377551107900213,2.9599444774935533,32.07328209752826,0.08,27,47,20,4.05869069550801,Aleatória
0,27,23,2,2,42,1.2272727272727273,1.0952380952380953,5,0,36,0,22,21,13,0.9953784385316868,5.114723843962645,0.86,5,2,21,21,0.8889686876112561,0.4190702026042222,0.29354352395090366,0.36917460154389636,1.8268282862112644,6.515912705720975,4.337301587301586,44.602618566967024,0.08,23,49,10,2.86896186440527,Humana
-1,25,25,5,4,28,1.7857142857142858,1.6666666666666667,2,0,16,1,14,15,18,0.9999999997114609,2.5541339040856883,0.58,11,10,14,14,1.0,1.2058530725810097,0.8692269873603531,1.0470501000475156,1.6498056081620702,5.110615049364324,5.047080053265326,28.93654157793355,0.0,30,48,29,4.735199727655047,Aleatória
-1,25,25,6,7,23,2.0833333333333335,2.0833333333333335,1,2,15,1,12,12,18,0.9999999997114609,2.156293115510969,0.48,13,13,11,12,1.0,1.6562172428626492,1.8911342863183693,1.777560750641795,1.565507047665824,6.1434864813433006,4.117053495954596,41.170632798552845,0.0,26,50,25,4.4743301624376555,Aleatória
-1,25,25,4,4,27,1.7857142857142858,1.7857142857142858,0,0,17,0,14,14,18,0.9999999997114609,2.5152335875619984,0.56,11,11,13,14,1.0,1.0126747770541304,1.1450871101343856,1.0809104250301114,0.9418829309543284,5.721084316223108,2.3409355275452404,36.734497940273684,0.0,30,50,24,4.395859717341203,Aleatória
1,21,29,5,7,24,1.6153846153846154,2.4166666666666665,0,1,13,2,13,12,18,0.9814538947451146,2.0223748416156684,0.5,8,17,12,12,0.7858751946471527,1.1461280327501029,1.6562172428626494,1.469693845669907,1.8900383817771433,5.150206434252992,6.32716049382716,30.333540569460972,-0.16,29,49,25,4.474330162437656,Aleatória
0,27,23,5,4,26,1.9285714285714286,1.7692307692307692,1,0,14,1,14,13,18,0.9953784385316868,2.210972636646596,0.54,13,10,13,13,0.8889686876112561,1.2797480619406367,0.890448992522325,1.1123449939023116,1.2630467652651167,5.0317108672281945,3.7111395715851936,28.96639895186195,0.08,33,45,28,4.6589002710392435,Aleatória
1,19,31,2,7,35,1.0555555555555556,1.7222222222222223,5,2,30,5,18,18,17,0.9580420219377606,4.223931817631531,0.72,1,13,18,17,0.6896598793878495,0.2290614236454256,1.5918387535438228,1.1850405004278632,3.7205778261954014,6.666634155241066,16.375051322304078,46.18727965152316,-0.24,23,42,15,3.3372918467029136,Humana
0,27,23,7,4,23,2.25,1.9166666666666667,0,0,9,3,12,12,17,0.9953784385316868,1.8356470248934025,0.48,15,11,12,11,0.8889686876112561,1.6393596310755,0.8620067027323834,1.3202482931462383,2.1279549956229515,4.125391989891567,8.407818923509147,18.83846586743072,0.08,31,48,28,4.615422010169678,Aleatória
1,24,26,4,5,28,1.7142857142857142,1.7333333333333334,2,2,18,1,14,15,18,0.9988455357066628,2.698814554577621,0.58,10,11,14,14,0.9434164716336324,1.0301575072754254,1.3399834161494522,1.200475530036497,1.7379592928596717,5.6443475778311845,4.7977240793386295,35.361526858222334,-0.04,33,49,27,4.621175542919471,Aleatória
0,27,23,4,2,44,1.173913043478261,1.0454545454545454,6,0,42,2,23,22,15,0.9953784385316868,5.879625838435639,0.9,4,1,22,22,0.8889686876112561,0.6360321234055564,0.20829889522526548,0.4817662975261953,5.059200401477563,6.828107418679079,29.249660479855216,47.753305643808226,0.08,20,49,14,2.652035277026935,Humana
0,29,21,4,3,29,1.9333333333333333,1.4,1,0,15,1,15,15,17,0.9814538947451146,2.6000000000000005,0.6,14,6,15,14,0.7858751946471527,0.85374989832438,0.6110100926607788,0.7888106377466153,1.0715348586736557,4.682294037323621,3.635204081632656,23.955708833724298,0.16,30,47,25,4.455748576083888,Aleatória
1,24,26,6,4,22,2.0,2.3636363636363638,1,0,12,2,12,11,18,0.9988455357066628,1.8023318229449317,0.46,12,15,11,11,0.9434164716336324,1.6832508230603465,1.2264306875665492,1.4935273075928408,1.0324581369746402,5.404188203749252,2.932823901177823,33.854266511223116,-0.04,28,49,24,4.42292738033765,Aleatória
0,30,20,5,5,27,2.142857142857143,1.4285714285714286,2,1,18,0,14,14,17,0.9709505941661296,2.6241951146970766,0.56,16,6,13,14,0.7369655941662062,1.456862718169367,1.049781318335648,1.3190132366156706,1.6122041717366729,5.974970671871551,4.168737798952538,39.195729679143454,0.2,27,50,22,4.2924925977289545,Humana
-1,25,25,3,10,32,1.4705882352941178,1.5625,3,2,25,7,17,16,17,0.9999999997114609,3.5811171441325405,0.66,8,9,16,16,1.0,0.6056253024110001,2.178553132241672,1.5786686397128613,4.709003636618116,6.340247988096177,25.32099368486446,42.78130073215006,0.0,23,47,15,3.5117067942312663,Humana
0,26,24,2,3,44,1.1304347826086956,1.0909090909090908,5,0,41,1,23,22,16,0.9988455357066628,5.74543296888929,0.9,3,2,22,22,0.9434164716336324,0.33678116053977536,0.4165977904505309,0.3784308081316978,3.6043172094350755,6.797143008711102,15.829369797859682,47.45968848450998,0.04,21,49,9,2.44074919043275,Humana
0,32,18,7,2,34,1.7777777777777777,1.0588235294117647,4,0,28,5,18,17,17,0.9426831889669534,3.9661064030103885,0.7,14,1,17,17,0.6438561897747247,1.5830896498638896,0.23529411764705885,1.2020390838835788,3.573427497765556,6.543109255618198,15.433065211146218,44.92612946782745,0.28,23,43,16,3.636736140416334,Humana
0,27,23,6,4,35,1.5,1.2777777777777777,4,0,30,2,18,18,17,0.9953784385316868,4.214451328464953,0.72,9,5,17,18,0.8889686876112561,1.3017082793177757,0.7307192465536614,1.061387398585711,3.0797403182321745,6.706018598695443,11.954220303997003,46.598826040606035,0.08,27,50,20,3.773486011187058,Humana
0,26,24,3,4,26,1.8571428571428572,1.8461538461538463,2,0,15,1,14,13,18,0.9988455357066628,2.3341807984815572,0.54,12,11,13,13,0.9434164716336324,0.989743318610787,1.0986812966989001,1.0436298373041015,0.6893920373925637,5.195664617646323,1.9560843606646818,30.659123944254905,0.04,30,47,24,4.457919564564538,Aleatória
0,27,23,6,5,26,1.9285714285714286,1.7692307692307692,1,1,15,1,14,13,18,0.9953784385316868,2.308332731648538,0.54,13,10,13,13,0.8889686876112561,1.3343958351621001,1.2498520622516862,1.2968252888897478,1.8046702152903755,5.348945123872199,5.591385931250316,32.02978920015693,0.08,31,49,25,4.517808423307221,Aleatória
1,1,49,1,49,1,1.0,49.0,0,9,1,48,1,1,10,0.14144054225328165,0.19595917942265426,0.04,0,48,0,1,0.029146345659516508,0.0,0.0,24.0,0.0,4.694855340334423,1.0,23.04166666666666,-0.96,13,50,2,0.15109697051711368,Humana
1,19,31,16,16,3,9.5,15.5,0,6,0,0,2,2,15,0.9580420219377606,0.3370459909270544,0.08,17,29,1,2,0.6896598793878495,6.5,0.5,5.5,-1.1359879789631855,4.498069636900927,2.3179427634724403,23.284467367585783,-0.24,16,50,10,2.196138586536031,Humana
0,33,17,9,4,22,2.75,1.5454545454545454,1,0,12,5,12,11,17,0.924818704684491,1.8353201355621858,0.46,21,6,11,11,0.5994620704162712,2.165063509461097,0.9875254992000196,1.8094480040595489,2.3381140787166044,5.207665981886747,9.039335641024273,31.68847940541877,0.32,31,48,23,4.363038521594967,Aleatória
1,21,29,3,4,31,1.3125,1.8125,3,0,21,1,16,16,17,0.9814538947451146,3.070895634827078,0.64,5,13,16,15,0.7858751946471527,0.582961190818051,1.0135796712641785,0.8637671850678283,1.2615201233632274,5.934835225048581,3.308598996738028,38.808166132381245,-0.16,30,44,21,4.197049999347146,Humana
0,27,23,5,3,30,1.8,1.4375,2,0,20,2,15,16,18,0.9953784385316868,2.924995726492605,0.62,12,7,15,15,0.8889686876112561,1.2220201853215575,0.7043392293490403,1.0057069205238642,1.782539257035049,5.943964060354912,5.617410963775848,38.78237965908714,0.08,28,49,25,4.437166989730119,Humana
0,28,22,4,4,28,2.0,1.4666666666666666,3,0,18,0,14,15,17,0.9895875209335165,2.6388633916896884,0.58,14,7,14,14,0.8365012677171205,1.1338934190276817,0.8844332774281066,1.0470501000475156,1.109085999251587,5.846119266363157,2.7558288357385847,38.10914185140586,0.12,29,49,25,4.484987227560984,Aleatória
-1,25,25,5,7,12,3.5714285714285716,4.166666666666667,0,2,0,2,7,6,15,0.9999999997114609,1.0919706955774957,0.26,18,19,6,6,1.0,0.7284313590846836,1.4624940645653537,1.166596222161777,1.4638246509386474,5.0937147013515975,4.4053308128544435,29.957528959266902,0.0,25,47,12,3.4406589663151634,Humana
0,29,21,4,3,33,1.7058823529411764,1.2352941176470589,2,0,23,1,17,17,17,0.9814538947451146,3.3908111124036386,0.68,12,4,17,16,0.7858751946471527,0.9557692240748189,0.5455069703232767,0.8129573506520736,1.9013722219699813,5.899280358215409,5.999314711767769,37.98479943180484,0.16,28,47,19,4.004555369515117,Humana
-1,25,25,4,3,37,1.3157894736842106,1.3157894736842106,3,0,30,1,19,19,16,0.9999999997114609,4.245279731654911,0.76,6,6,18,19,1.0,0.7292845505553167,0.653140718210045,0.6922603388403109,2.3441416786431253,6.550112458255147,7.952186842193184,45.03153108959359,0.0,27,50,19,3.8896215330411392,Humana
-1,25,25,9,12,19,2.5,2.5,2,2,15,3,10,10,18,0.9999999997114609,2.1071307505705477,0.4,15,15,10,9,1.0,3.0083217912982647,3.2939338184001206,3.1543620591175006,1.992932974397613,6.64923655402832,5.518168733112801,46.09909909909911,0.0,22,45,18,3.6594618264514813,Humana
1,24,26,6,5,21,2.1818181818181817,2.3636363636363638,2,3,11,1,11,11,18,0.9988455357066628,1.710672382427448,0.44,13,15,11,10,0.9434164716336324,1.4658650451451907,1.7200807207658637,1.6006197146962735,1.0135370538886328,5.0042767125018255,2.693673257023933,29.62134178075659,-0.04,31,42,28,4.675310868912363,Aleatória
0,26,24,3,4,40,1.3,1.1428571428571428,4,0,35,1,20,21,16,0.9988455357066628,4.918089059787347,0.82,6,3,20,20,0.9434164716336324,0.5567764362830021,0.63887656499994,0.6053499339507734,3.152520715916825,6.714768143681504,12.965814218249282,46.66291109991895,0.04,22,49,12,2.9124401252748346,Humana
0,30,20,5,4,30,1.875,1.3333333333333333,4,0,24,1,16,15,17,0.9709505941661296,3.393464306575215,0.62,14,5,15,15,0.7369655941662062,1.3635890143294642,0.8692269873603531,1.1826001793434426,1.602172311291825,6.549058619043541,4.0162295386904745,45.07524010781759,0.2,26,47,16,3.521543525137056,Humana
0,26,24,4,5,28,1.7333333333333334,1.7142857142857142,1,1,16,1,15,14,18,0.9988455357066628,2.50671099251589,0.58,11,10,14,14,0.9434164716336324,0.9285592184789413,1.097306535409801,1.0135819625309703,1.5651880349091976,5.181293083848168,5.043901105967075,30.193919467933327,0.04,33,49,27,4.631832608042798,Aleatória
1,24,26,4,5,27,1.7142857142857142,1.8571428571428572,1,1,14,1,14,14,18,0.9988455357066628,2.3337523433303717,0.56,10,12,14,13,0.9434164716336324,0.8806305718527108,1.124858267715973,1.0126747770541304,1.4696454921471682,4.776696359334328,4.844657310462611,25.447407038929782,-0.04,31,48,30,4.762267390651493,Aleatória
0,27,23,6,9,21,2.4545454545454546,2.090909090909091,0,1,13,3,11,11,17,0.9953784385316868,1.8778711350888806,0.44,16,12,10,11,0.8889686876112561,1.7248787237282068,2.3531234737354154,2.071051954526276,1.8438491105501558,6.03733233424208,5.802744272556157,40.1062788824806,0.08,27,50,21,4.216193141113152,Humana
0,27,23,4,5,22,2.25,2.090909090909091,1,1,11,1,12,11,18,0.9953784385316868,1.7459667808981936,0.46,15,12,11,11,0.8889686876112561,1.2332207155790618,1.378704626191191,1.3072431633367745,0.6105915368653501,4.779018386492186,1.9507009162816202,27.331325567249955,0.08,29,48,25,4.51205489055743,Aleatória
0,28,22,4,4,28,2.0,1.4666666666666666,2,0,19,0,14,15,18,0.9895875209335165,2.7501999927278025,0.58,14,7,14,14,0.8365012677171205,1.1338934190276817,1.0241527663824812,1.110965771971518,1.1625997520180418,6.066137239435616,2.7276832949090637,40.32043162343365,0.12,30,49,23,4.316827716832514,Humana
-1,25,25,6,9,19,2.5,2.5,0,2,8,3,10,10,17,0.9999999997114609,1.4966629547095762,0.4,15,15,10,9,1.0,1.4317821063276353,2.6172504656604803,2.1095023109728985,1.7896547821913746,4.345381442165402,5.381264991793965,20.89349489795919,0.0,27,39,24,4.280925880867226,Aleatória
0,27,23,6,6,24,2.076923076923077,1.9166666666666667,2,1,13,0,13,12,18,0.9953784385316868,2.0322401432901573,0.5,14,11,12,12,0.8889686876112561,1.4915938022819473,1.3819269959814164,1.4422205101855958,1.680101555874492,5.082715177597226,5.0295857988165675,29.754674061523488,0.08,31,49,30,4.827909782143968,Aleatória
-1,25,25,4,6,26,1.9230769230769231,1.7857142857142858,0,1,14,2,13,14,18,0.9999999997114609,2.2289908030317216,0.54,12,11,13,13,1.0,0.9166442529086912,1.372098050878468,1.1770554505237558,1.7876958026397036,4.9531481610912325,6.400319576512107,28.12389081703073,0.0,31,49,25,4.484987227560983,Humana
0,28,22,5,4,24,2.1538461538461537,1.8333333333333333,0,0,11,1,13,12,18,0.9895875209335165,1.8894443627691184,0.5,15,10,12,12,0.8365012677171205,1.2307692307692308,0.9860132971832695,1.131370849898476,0.9943689110435824,4.367474905819444,3.125,22.12355530447473,0.12,31,48,29,4.784431521274403,Aleatória
-1,25,25,7,4,25,1.9230769230769231,1.9230769230769231,1,0,13,3,13,13,18,0.9999999997114609,2.1094074997496337,0.52,12,12,13,12,1.0,1.5913969896597846,0.9970370305242863,1.327898192433236,2.210806043118119,4.798414862436959,8.63154812846268,26.437212057314497,0.0,32,48,29,4.735199727655046,Aleatória
1,23,27,5,5,25,1.7692307692307692,2.076923076923077,2,1,13,0,13,13,18,0.9953784385316868,2.0903588208726274,0.52,10,14,12,13,0.8889686876112561,1.1200169060431568,1.268647884805434,1.2064913185660093,1.330358239087038,4.87876728151361,3.8364069006543704,27.30508311410511,-0.08,31,50,28,4.664653803789035,Aleatória
1,17,33,3,4,30,1.1333333333333333,2.0625,4,0,19,1,15,16,17,0.924818704684491,2.841760018017004,0.62,2,17,15,15,0.5994620704162712,0.49888765156985887,0.899218410621135,0.8679757449724973,1.1306489547817746,5.610768249736607,3.0574005677482385,35.37143447342517,-0.32,25,49,16,3.7229332294633073,Humana
0,32,18,9,3,22,2.6666666666666665,1.6363636363636365,1,0,10,6,12,11,17,0.9426831889669534,1.7912007146045916,0.46,20,7,11,11,0.6438561897747247,2.2484562605386738,0.77138921583987,1.785257840665027,2.534121363866779,4.512889466068843,9.698920986309695,22.388294326072522,0.28,29,48,26,4.501397825434102,Aleatória
1,23,27,5,7,21,2.090909090909091,2.4545454545454546,1,2,9,2,11,11,18,0.9953784385316868,1.6989408465276243,0.44,12,16,10,11,0.8889686876112561,1.2398346997259868,1.9241827716833384,1.6287702606517196,1.4496135935558387,4.336365445820087,4.207791073456195,20.76309605164181,-0.08,28,50,28,4.631832608042798,Aleatória
1,23,27,4,4,26,1.7692307692307692,1.9285714285714286,0,0,14,0,13,14,17,0.9953784385316868,2.2199999999999998,0.54,10,13,13,13,0.8889686876112561,1.0490908997681427,0.9609731462195507,1.0075163339804034,0.7340223821660876,4.909815586221727,2.1706281957633293,28.091591463139096,-0.08,28,47,23,4.32173124920605,Aleatória
-1,25,25,5,7,24,1.9230769230769231,2.0833333333333335,1,1,13,2,13,12,18,0.9999999997114609,2.0615528128088303,0.5,12,13,12,12,1.0,1.2064913185660096,1.753963764987432,1.4966629547095767,1.8612836490329552,5.081264012525904,5.994897959183672,29.018269896193775,0.0,33,48,25,4.457919564564537,Humana
1,21,29,6,5,24,1.75,2.230769230769231,2,1,13,1,12,13,18,0.9814538947451146,2.0024984394500787,0.5,9,16,12,12,0.7858751946471527,1.5343293866268306,1.1200169060431566,1.3564659966250536,1.4423669623848632,5.185542068687464,4.371455576559546,31.065882674858994,-0.16,29,48,23,4.398030705821854,Aleatória
0,27,23,5,7,19,2.7,2.3,0,2,9,2,10,10,18,0.9953784385316868,1.414213562373095,0.4,17,13,10,9,0.8889686876112561,1.4177446878757827,2.0024984394500787,1.746424919657298,0.9574595098363042,4.785698695070558,2.952163396936308,27.879200000000015,0.08,32,39,24,4.414441303694972,Humana
1,19,31,4,6,26,1.4615384615384615,2.2142857142857144,4,1,16,2,13,14,18,0.9580420219377606,2.4017493624439665,0.54,6,17,13,13,0.6896598793878495,0.9294650748918901,1.3720980508784675,1.2383891479481843,1.5696853228109837,5.580794506713265,5.2947747223031145,34.895142775325624,-0.24,26,48,24,4.290321609248305,Aleatória
-1,25,25,3,4,33,1.4705882352941178,1.4705882352941178,4,0,23,1,17,17,17,0.9999999997114609,3.3611902653673154,0.68,8,8,17,16,1.0,0.6960093862470137,0.8483650059915269,0.7759356446042893,1.6089977442166035,5.988364617120624,4.789139912802221,39.145754114994524,0.0,26,47,20,3.921592728411122,Humana
0,26,24,3,6,32,1.625,1.411764705882353,2,1,23,3,16,17,18,0.9988455357066628,3.326319287140067,0.66,10,7,16,16,0.9434164716336324,0.6959705453537527,1.2394886768062046,1.018650685695249,2.7971737784197854,6.141361478394613,11.85147309891143,40.830972686568494,0.04,26,49,20,3.9944598598040257,Humana
0,27,23,2,3,38,1.35,1.2105263157894737,3,0,29,1,20,19,17,0.9953784385316868,4.225115383039852,0.78,7,4,19,19,0.8889686876112561,0.4769696007084729,0.5210260492953508,0.5037662231894486,1.554387052802302,6.100527389522975,4.492912561411046,40.089511308225056,0.08,27,48,15,3.58800625084707,Humana
1,24,26,3,6,27,1.7142857142857142,1.8571428571428572,3,1,17,3,14,14,18,0.9988455357066628,2.5780612870915234,0.56,10,12,13,14,0.9434164716336324,0.8806305718527109,1.4069796859708719,1.175862688082452,1.7389850121595745,5.5056543343403,6.298130472079629,33.86915976132198,-0.04,29,50,24,4.40868777094518,Aleatória
0,27,23,2,3,38,1.35,1.2105263157894737,4,0,30,1,20,19,17,0.9953784385316868,4.295532563024053,0.78,7,4,19,19,0.8889686876112561,0.4769696007084728,0.6137844099837158,0.5523245956035387,1.8349420809090147,6.35089838041888,5.364595719381691,42.91264047758127,0.08,26,49,16,3.4812068060119215,Humana
0,28,22,4,5,23,2.3333333333333335,1.8333333333333333,1,1,12,1,12,12,18,0.9895875209335165,1.9208331525668751,0.48,16,10,11,12,0.8365012677171205,1.3123346456686351,1.2801909579781015,1.3202482931462383,0.8243248021333061,4.822332839581472,2.154203901525373,27.105247895869528,0.12,32,50,27,4.561286684176786,Aleatória
0,26,24,5,4,22,2.1666666666666665,2.1818181818181817,0,0,11,1,12,11,18,0.9988455357066628,1.7459667808981936,0.46,14,13,11,11,0.9434164716336324,1.4043582955293932,1.192261549873091,1.3072431633367745,0.6105915368653502,4.779018386492186,1.950700916281621,27.331325567249955,0.04,29,49,19,3.9966308482846755,Humana
0,29,21,3,1,40,1.45,1.0,4,0,33,2,20,21,15,0.9814538947451146,4.7018719676316145,0.82,9,0,20,20,0.7858751946471527,0.5894913061275798,0.0,0.4691557088212523,2.036786905463754,6.452165626553264,6.405741417092768,43.9430187541438,0.16,21,49,10,2.9617315702563363,Humana
0,33,17,7,5,26,2.357142857142857,1.3076923076923077,1,1,18,2,14,13,17,0.924818704684491,2.5784491462892967,0.54,19,4,13,13,0.5994620704162712,1.7569105537498344,1.0658774200423862,1.5564371399593107,1.9563145787158644,6.254148729443168,5.878180274442757,42.119304048498684,0.32,25,49,19,3.9739051622495283,Humana
-1,25,25,6,4,23,2.0833333333333335,2.0833333333333335,1,0,13,2,12,12,18,0.9999999997114609,2.0023985617254123,0.48,13,13,11,12,1.0,1.4976833963009524,1.3819269959814167,1.4409680388158819,1.1075021071701308,5.215660361374949,3.10624042236664,31.279859223736942,0.0,24,50,21,4.229871195093384,Humana
0,27,23,3,2,39,1.35,1.15,3,0,31,1,20,20,15,0.9953784385316868,4.458699361921591,0.8,7,3,20,19,0.8889686876112561,0.5722761571129799,0.3570714214271425,0.48733971724044817,1.7819624009900046,6.2935768313202445,5.332409972299169,42.23143691120566,0.08,25,48,16,3.6976884586213474,Humana
0,29,21,4,3,28,1.9333333333333333,1.5,3,0,17,1,15,14,16,0.9814538947451146,2.554133904085689,0.58,14,7,14,14,0.7858751946471527,1.1234866364235145,0.7319250547113999,0.9789703149364407,1.0147513848861525,5.51392439612634,2.6883454734651404,34.52546008674873,0.16,26,47,18,4.023698511281123,Humana
-1,25,25,3,4,23,2.0833333333333335,2.0833333333333335,0,0,8,1,12,12,18,0.9999999997114609,1.7690675509996785,0.48,13,13,12,11,1.0,0.759202798262025,1.114924013354971,0.9537935951882998,0.4095070922060129,3.6743213653505546,2.1269739525668663,14.972072716323526,0.0,29,43,23,4.425098368818299,Aleatória
0,26,24,4,4,27,1.8571428571428572,1.7142857142857142,2,0,16,0,14,14,18,0.9988455357066628,2.409647277092646,0.56,12,10,14,13,0.9434164716336324,1.1248582677159729,0.9583148474999097,1.0473484499010846,0.9953945289573695,5.454047712982627,2.580010816657652,34.050934038368986,0.04,31,47,28,4.691721466785482,Humana
0,30,20,4,3,25,2.3076923076923075,1.5384615384615385,0,0,12,1,13,13,16,0.9709505941661296,2.09990475974507,0.52,17,7,13,12,0.7369655941662062,0.910166120476864,0.8426500884694863,0.9576845844606717,0.4166376389920056,4.352218947362348,1.741144640998959,21.502549918794422,0.2,29,48,22,4.243260804109598,Humana
0,27,23,6,5,22,2.4545454545454546,1.9166666666666667,0,1,10,1,11,12,17,0.9953784385316868,1.6877203559831826,0.46,16,11,11,11,0.8889686876112561,1.4993111365882401,1.1873172373979173,1.3721507685269132,1.1996858176344407,4.374983952295317,3.808632118836794,22.518382557323882,0.08,28,47,25,4.501397825434102,Aleatória
0,26,24,5,4,17,2.888888888888889,2.6666666666666665,1,0,5,1,9,9,18,0.9988455357066628,1.2768711759609894,0.36,17,15,8,9,0.9434164716336324,1.286204100310025,1.247219128924647,1.2717247935843996,-0.22676288493492575,3.6278571164750124,1.8238447642911253,14.596240613813501,0.04,28,50,18,3.8790241192799573,Humana
0,35,15,6,1,30,2.1875,1.0,3,0,25,5,16,15,17,0.8812908989421536,3.5093589158135425,0.62,19,0,15,15,0.5145731728297583,1.8445443204217133,0.0,1.4519712819260515,2.2730156653207394,6.70327602985644,6.5939016867592,46.58764872941636,0.4,23,49,12,3.422077379961395,Humana
0,27,23,4,3,35,1.5,1.2777777777777777,3,0,27,1,18,18,16,0.9953784385316868,3.842082768499399,0.72,9,5,17,18,0.8889686876112561,0.8333333333333334,0.6502611061510903,0.7556372504853024,1.9250700699580572,6.426163076221678,5.794623813002195,43.813287188408815,0.08,29,50,23,4.193969359128096,Humana
0,32,18,10,5,16,4.0,2.0,0,1,7,5,8,9,18,0.9426831889669534,1.1934822998268553,0.34,24,9,8,8,0.6438561897747247,2.692582403567252,1.3333333333333333,2.312894500157353,1.5548922145284307,4.2634260310117025,5.422671535607476,21.66756424969843,0.28,27,48,17,3.876291575387071,Aleatória
1,22,28,6,5,21,2.0,2.5454545454545454,0,1,9,1,11,11,18,0.9895875209335165,1.538310761842353,0.44,11,17,10,11,0.8365012677171205,1.4770978917519928,1.304790917673393,1.4200453956193917,1.035839348309576,4.2170542652010985,3.251612469766191,21.32122740681919,-0.12,28,50,24,4.3873736406985255,Aleatória
0,27,23,5,4,23,2.25,1.9166666666666667,1,0,12,1,12,12,18,0.9953784385316868,1.8787229705307806,0.48,15,11,11,12,0.8889686876112561,1.4215601757693317,1.0374916331657276,1.2555432644432802,0.7268793623953876,4.971510333528624,2.2285897261736114,29.07763340563813,0.08,30,50,26,4.571943749300113,Aleatória
1,14,36,1,4,26,1.0,2.769230769230769,0,0,15,3,14,13,16,0.8554508102715916,2.4348305895893456,0.54,0,23,13,13,0.47393118833241243,0.0,0.696568087549032,1.0075163339804034,0.5167366553391746,5.022534642051553,1.6114974433893345,27.798550669935754,-0.44,18,49,9,2.5883090274540055,Humana
1,23,27,6,6,30,1.5333333333333334,1.6875,3,2,23,0,15,16,17,0.9953784385316868,3.2856658381521395,0.62,8,11,15,15,0.8889686876112561,1.2578641509408806,1.4882351124738322,1.3837168122275623,2.468350363333938,6.363044396584749,7.7067934782608685,43.115307836629206,-0.08,27,49,23,4.23260373898627,Humana
0,30,20,4,3,28,2.0,1.4285714285714286,1,0,16,1,15,14,18,0.9709505941661296,2.482659863936258,0.58,15,6,14,14,0.7369655941662062,1.0327955589886444,0.7284313590846835,0.9430892642191272,1.066992946112768,5.182302314130769,2.994430781549372,30.73574051330212,0.2,28,49,22,4.327484781955842,Humana
0,26,24,5,4,27,1.8571428571428572,1.7142857142857142,2,0,18,1,14,14,18,0.9988455357066628,2.6165626306282066,0.56,12,10,14,13,0.9434164716336324,1.3014905113063284,1.0301575072754254,1.175862688082452,1.2117753255651784,6.017764040583895,3.2236625318282703,39.643598051998374,0.04,28,44,25,4.468576629687864,Aleatória
0,31,19,11,4,22,2.5833333333333335,1.7272727272727273,2,0,15,7,12,11,17,0.9580420219377606,2.137381575666825,0.46,19,8,11,11,0.6896598793878495,2.9568658332016953,1.0523488093445659,2.2965413297816095,2.6297243637288843,6.310493600677031,9.900937295255718,42.84933532386931,0.24,29,49,23,4.201953531720682,Aleatória
1,21,29,7,14,15,2.625,3.625,1,3,11,7,8,8,17,0.9814538947451146,1.5676734353812343,0.32,13,21,7,8,0.7858751946471527,2.54644359843292,4.715334028465004,3.822221212855164,1.6770073449883378,6.345639595902715,4.642810489290515,43.11174265543617,-0.16,19,50,17,3.417735403000096,Humana
1,19,31,2,6,28,1.2666666666666666,2.2142857142857144,2,1,17,4,15,14,17,0.9580420219377606,2.5775181861628065,0.58,4,17,14,14,0.6896598793878495,0.44221663871405337,1.4232042032265195,1.1415824384308173,2.0833944125548083,5.4861612344533555,7.588673477542759,33.727048494045015,-0.24,28,49,22,4.2924925977289545,Humana
1,24,26,4,4,25,1.8461538461538463,2.0,3,0,12,0,13,13,18,0.9988455357066628,2.0222759455623263,0.52,11,13,12,13,0.9434164716336324,1.0262818510866412,1.0377490433255416,1.0348941574672084,0.7786108846876392,4.439937765380638,2.344281310094319,23.103084338057577,-0.04,29,50,24,4.381620107948734,Aleatória
0,27,23,2,3,39,1.35,1.15,4,0,31,1,20,20,15,0.9953784385316868,4.458699361921591,0.8,7,3,19,20,0.8889686876112561,0.4769696007084729,0.47696960070847283,0.48733971724044817,1.7819624009900046,6.2935768313202445,5.332409972299169,42.23143691120566,0.08,24,50,13,3.244765266096638,Humana
0,30,20,7,3,29,2.0,1.3333333333333333,2,0,20,4,15,15,16,0.9709505941661296,2.891366458960192,0.6,15,5,15,14,0.7369655941662062,1.591644851508443,0.699205898780101,1.2736648783028532,2.674481138714379,6.115219209977728,10.794708200412837,40.65289256198342,0.2,29,46,21,4.197049999347146,Humana
-1,25,25,5,6,21,2.272727272727273,2.272727272727273,1,1,9,1,11,11,18,0.9999999997114609,1.5640971836813722,0.44,14,14,11,10,1.0,1.5427784316797402,1.3545149477955762,1.4517017656973918,1.0343751819806464,4.266552540289631,3.0625605536332174,21.305010477615877,0.0,26,42,27,4.571943749300114,Aleatória
0,26,24,7,7,26,1.8571428571428572,1.8461538461538463,3,2,22,0,14,13,18,0.9988455357066628,3.099741924741478,0.54,12,11,13,13,0.9434164716336324,2.099562636671296,1.8332885058173825,1.97584869160728,2.049922685102694,6.641816020083644,5.3877540891557185,45.954695447860864,0.04,26,49,22,4.030713380773162,Humana
1,7,43,3,41,6,1.75,14.333333333333334,0,8,4,38,4,3,13,0.5842388113543169,0.6003332407921455,0.14,3,40,3,3,0.2175914350726268,0.82915619758885,18.856180831641264,13.840195822608987,2.0302232985521944,5.4810845442457214,5.142089816547206,34.43836235727721,-0.72,20,49,10,1.3333494663119878,Humana
0,27,23,5,4,28,1.8,1.6428571428571428,2,0,16,1,15,14,18,0.9953784385316868,2.5541339040856883,0.58,12,9,14,14,0.8889686876112561,1.1661903789690602,0.8949974347244049,1.0470501000475156,1.64980560816207,5.110615049364324,5.047080053265324,28.93654157793355,0.08,31,49,25,4.484987227560983,Aleatória
-1,25,25,5,4,23,2.0833333333333335,2.0833333333333335,0,0,9,1,12,12,18,0.9999999997114609,1.8137254478007416,0.48,13,13,12,11,1.0,1.2555432644432802,1.0374916331657276,1.1516895800904379,0.9826976576589218,4.195537168213606,2.999835530824263,19.566401932656046,0.0,28,46,25,4.544876086303668,Aleatória
0,26,24,4,6,25,2.0,1.8461538461538463,1,2,14,2,13,13,17,0.9988455357066628,2.1469979040511427,0.52,13,11,12,13,0.9434164716336324,0.9607689228305228,1.6098807335735654,1.327898192433236,1.6194693700182052,5.301552809341,4.93198504571866,31.966339809553094,0.04,29,50,25,4.484987227560984,Humana
0,35,15,10,3,23,2.9166666666666665,1.25,1,0,13,7,12,12,17,0.8812908989421536,2.0023985617254123,0.48,23,3,12,11,0.5145731728297583,2.3258809561588105,0.5951190357119042,1.8911342863183696,3.0219359739478024,5.215660361374949,12.909631444999528,31.279859223736935,0.4,29,45,22,4.0999979678969245,Aleatória
1,24,26,4,5,29,1.6,1.7333333333333334,3,1,22,1,15,15,18,0.9988455357066628,3.1240998703626617,0.6,9,11,14,15,0.9434164716336324,1.083205120618128,1.339983416149452,1.2202003478482082,1.5371425633953268,6.449595455964032,3.752506126085988,44.063826928245064,-0.04,29,50,23,4.33597085859852,Humana
1,19,31,4,5,19,1.9,3.1,0,3,6,1,10,10,17,0.9580420219377606,1.3266499161421597,0.4,9,21,9,10,0.6896598793878495,0.9433981132056604,1.445683229480096,1.3601470508735443,0.596119963859844,3.2994934639589375,2.2388604821037252,12.434917355371905,-0.24,30,50,24,4.392277173072061,Aleatória
0,27,23,3,2,38,1.35,1.2105263157894737,4,0,29,1,20,19,17,0.9953784385316868,4.225115383039852,0.78,7,4,19,19,0.8889686876112561,0.5722761571129799,0.40768245749551757,0.5037662231894487,1.5543870528023005,6.100527389522975,4.4929125614110434,40.089511308225056,0.08,25,49,17,3.7969114785522176,Humana
1,24,26,3,7,39,1.2,1.3,5,1,36,4,20,20,16,0.9988455357066628,5.039841267341663,0.8,4,6,20,19,0.9434164716336324,0.5099019513592785,1.3076696830622023,0.9937303457175896,4.986962734798094,6.810675691687777,28.28473001121615,47.592567425134774,-0.04,21,47,17,3.059196188235786,Humana
0,27,23,3,4,36,1.4210526315789473,1.2777777777777777,3,0,27,1,19,18,17,0.9953784385316868,3.9182138787973275,0.74,8,5,18,18,0.8889686876112561,0.5907880084379907,0.7307192465536614,0.6664231354561055,2.1983937490245355,6.1417782584877125,8.006394996537402,40.588094422797106,0.08,25,48,22,4.0231369558688845,Humana
0,31,19,7,5,30,1.9375,1.2666666666666666,3,1,24,2,16,15,18,0.9580420219377606,3.369807116141813,0.62,15,4,15,15,0.6896598793878495,1.5995604865087159,0.9977753031397179,1.3837168122275623,2.5414050199142872,6.6769205791891855,8.950053166351603,46.34553861053569,0.24,24,43,20,4.015212434638444,Humana
1,23,27,5,4,29,1.5333333333333334,1.8,1,0,18,1,15,15,17,0.9953784385316868,2.705549851693737,0.6,8,12,14,15,0.8889686876112561,1.0873004286866728,0.9092121131323904,1.0110500592068732,1.6699527206654174,5.588997543676208,5.3024574669187166,34.85487772104271,-0.08,30,50,27,4.59901141229656,Aleatória
1,23,27,6,8,16,2.5555555555555554,3.375,1,2,5,2,9,8,18,0.9953784385316868,1.0121264743103997,0.34,14,19,8,8,0.8889686876112561,1.5713484026367723,2.1758618981911515,1.9241679098583677,1.0743240018258393,3.333076264920471,3.5887658310769495,13.527993796351454,-0.08,32,48,22,4.249014336859389,Humana
1,24,26,4,6,25,1.8461538461538463,2.0,1,2,15,2,13,13,18,0.9988455357066628,2.2202702538204666,0.52,11,13,12,13,0.9434164716336324,1.026281851086641,1.6172150801252798,1.356553237580646,1.5261066136738664,5.691088552566561,4.5518036414015555,36.42521412293268,-0.04,29,50,20,4.1727148802435865,Humana
0,26,24,4,3,29,1.7333333333333334,1.6,3,0,15,1,15,15,18,0.9988455357066628,2.6000000000000005,0.6,11,9,14,15,0.9434164716336324,0.9285592184789413,0.6110100926607788,0.7888106377466155,1.0715348586736544,4.682294037323621,3.6352040816326525,23.955708833724298,0.04,26,50,23,4.3274847819558415,Aleatória
1,22,28,4,17,21,2.0,2.5454545454545454,2,3,15,13,11,11,16,0.9895875209335165,2.1648094604375694,0.44,11,17,11,10,0.8365012677171205,1.1281521496355325,4.5798697155672725,3.34639314896472,3.845062730895031,6.167349667852745,17.069250691030902,41.073836457944445,-0.12,27,46,21,3.8034474703072716,Humana
-1,25,25,5,6,24,1.9230769230769231,2.0833333333333335,2,2,14,1,13,12,18,0.9999999997114609,2.090454496036687,0.5,12,13,12,12,1.0,1.2686478848054341,1.6562172428626494,1.469693845669907,1.4364291701506289,5.589315887271402,3.8580246913580245,35.228885316464975,0.0,31,49,26,4.571943749300114,Aleatória
1,6,44,1,7,12,1.0,6.285714285714286,0,6,6,6,6,7,14,0.5293608649988253,1.0355674772799695,0.26,0,37,6,6,0.18442457113742744,0.0,1.0301575072754257,2.7413122586469942,0.02664659531965245,4.435626481808993,1.1339983879967754,22.449162819965785,-0.76,19,44,6,2.4464124990649547,Humana
0,27,23,3,3,37,1.4210526315789473,1.2105263157894737,3,0,28,0,19,19,16,0.9953784385316868,4.057388322554299,0.76,8,4,18,19,0.8889686876112561,0.5907880084379908,0.5210260492953508,0.5668594533825794,1.6232333871683666,6.160202995453879,4.619203329369797,40.83646468739694,0.08,26,50,18,3.759748305844681,Humana
1,24,26,6,3,20,2.4,2.3636363636363638,0,0,9,3,10,11,17,0.9988455357066628,1.6743954132760877,0.42,14,15,10,10,0.9434164716336324,1.8547236990991407,0.8813963377120598,1.430157849302972,0.7773333757000479,4.535972845508875,2.9526034778590082,22.194000311158547,-0.04,28,47,21,4.108484044539603,Humana
0,29,21,3,2,35,1.6111111111111112,1.1666666666666667,3,0,24,1,18,18,16,0.9814538947451146,3.6168494577463415,0.72,11,3,18,17,0.7858751946471527,0.6781419786518723,0.3726779962499649,0.5905636562630361,1.2454145301786383,5.664485955065441,3.5211058031169253,35.19589385763684,0.16,27,47,17,3.854629348814253,Humana
0,28,22,2,1,44,1.2173913043478262,1.0,5,0,40,1,23,22,16,0.9895875209335165,5.629387178015027,0.9,5,0,22,22,0.8365012677171205,0.4124709991523973,0.0,0.3142696805273545,2.4748737341529154,6.70537921297068,7.124999999999998,46.55334600407207,0.12,19,49,6,2.40056537243482,Humana
1,22,28,6,5,24,1.8333333333333333,2.1538461538461537,2,1,14,1,12,13,18,0.9895875209335165,2.071231517720798,0.5,10,15,12,12,0.8365012677171205,1.404358295529393,1.4058205294228512,1.4142135623730951,1.357645019878171,5.665356882546008,3.86,36.30943648426166,-0.12,29,49,26,4.604764945046352,Aleatória
1,10,40,4,11,13,1.4285714285714286,5.714285714285714,0,6,7,7,7,7,14,0.7219280945988233,1.0961751684835777,0.28,3,33,6,7,0.3219280948873623,1.0497813183356477,3.0572763655760995,3.133101742780187,1.0678581866733443,4.987005102494519,3.1372573597105826,29.138684151269228,-0.6,20,50,10,2.8180873828810973,Humana
0,28,22,3,2,31,1.75,1.375,1,0,16,1,16,16,17,0.9895875209335165,2.9513386793114753,0.64,12,6,16,15,0.8365012677171205,0.6614378277661477,0.4841229182759271,0.6091746465505602,0.5896675581457833,4.666911706252465,2.4178393351800556,23.07404440159128,0.12,29,46,18,3.961638664057789,Aleatória
1,24,26,4,5,22,2.0,2.3636363636363638,1,1,8,1,12,11,17,0.9988455357066628,1.6273905493150682,0.46,12,15,11,11,0.9434164716336324,1.0,1.2264306875665492,1.1287613031084496,0.743396793379352,3.7187800859356823,2.773542956264474,15.665979312162355,-0.04,27,49,23,4.354552444952288,Aleatória
-1,25,25,6,5,26,1.7857142857142858,1.9230769230769231,0,1,14,1,14,13,18,0.9999999997114609,2.264597094407745,0.54,11,12,13,13,1.0,1.3720980508784677,1.071414482860317,1.238389147948184,1.9207097409221288,4.928165321691249,6.407587981349267,27.346100182566378,0.0,29,44,27,4.480645250599684,Aleatória
-1,25,25,9,5,21,2.272727272727273,2.272727272727273,2,1,8,4,11,11,18,0.9999999997114609,1.6511813952440235,0.44,14,14,10,11,1.0,2.2193737483152187,1.1354541815269816,1.7627926754241194,2.5692264341648565,4.024178025783742,10.005856722498871,18.01517556040467,0.0,30,50,26,4.526294499949899,Aleatória
0,28,22,4,3,35,1.5555555555555556,1.2222222222222223,1,0,27,1,18,18,17,0.9895875209335165,3.842082768499399,0.72,10,4,17,18,0.8365012677171205,0.8958064164776167,0.5328701692569688,0.7556372504853023,1.9250700699580576,6.426163076221678,5.794623813002196,43.813287188408815,0.12,27,50,18,3.8759434790609073,Humana
0,26,24,3,2,46,1.0833333333333333,1.0434782608695652,7,0,45,1,24,23,14,0.9988455357066628,6.29733276872042,0.94,2,1,23,23,0.9434164716336324,0.39965262694272663,0.20393111999232305,0.3198573697526151,5.244994546609075,6.8469205470735846,30.128945101417507,47.927593455201794,0.04,18,49,11,2.137273417331148,Humana
0,30,20,5,6,24,2.3076923076923075,1.6666666666666667,1,1,13,1,13,12,18,0.9709505941661296,2.0615528128088303,0.5,17,8,12,12,0.7369655941662062,1.3803352649943355,1.4337208778404376,1.4422205101855958,1.520091883886445,5.081264012525904,4.1420118343195265,29.018269896193775,0.2,29,48,26,4.466405641207214,Aleatória
0,26,24,5,5,23,2.1666666666666665,2.0,1,1,12,0,12,12,18,0.9988455357066628,1.857309882599024,0.48,14,12,11,12,0.9434164716336324,1.2801909579781015,1.35400640077266,1.3202482931462383,0.9329606515907767,5.051054215936047,2.620482214568023,30.13874040086604,0.04,30,50,27,4.648243205915917,Aleatória
-1,25,25,5,4,28,1.6666666666666667,1.7857142857142858,2,0,19,1,15,14,18,0.9999999997114609,2.735616932247643,0.58,10,11,14,14,1.0,1.2472191289246468,1.0126747770541304,1.141582438430817,1.3880476783066173,6.152882305890002,3.7491941499280728,41.1762680942599,0.0,29,49,23,4.311074184082723,Humana
1,24,26,5,3,25,1.8461538461538463,2.0,0,0,9,2,13,13,18,0.9988455357066628,2.2021807373601283,0.52,11,13,13,12,0.9434164716336324,1.2307692307692306,0.5547001962252291,0.9576845844606717,1.4675594448076617,4.776729357687856,5.370863683662848,25.03334530319659,-0.04,26,44,19,4.0209659673882365,Aleatória
-1,25,25,5,4,25,1.9230769230769231,1.9230769230769231,2,0,13,1,13,13,18,0.9999999997114609,2.0903588208726274,0.52,12,12,13,12,1.0,1.2686478848054341,1.071414482860317,1.1741798094210576,1.147166039007771,4.87876728151361,3.1885833225883697,27.30508311410511,0.0,28,46,25,4.517808423307221,Aleatória
1,22,28,2,3,34,1.2222222222222223,1.6470588235294117,4,0,22,1,18,17,17,0.9895875209335165,3.419064199455752,0.7,4,11,17,17,0.8365012677171205,0.41573970964154905,0.6809315825170721,0.5993193418115152,1.0726454129012908,5.375384670897741,3.1249999999999982,31.773751043678246,-0.12,27,48,18,4.002384381034467,Humana
0,28,22,3,3,36,1.5555555555555556,1.1578947368421053,1,0,26,0,18,19,17,0.9895875209335165,3.830456891808078,0.74,10,3,18,18,0.8365012677171205,0.5983516452371671,0.4880851839734581,0.5796651510683032,1.427948667227124,5.930074970696579,4.01321361058601,38.257448822241244,0.12,25,49,15,3.462063664245916,Humana
1,23,27,4,4,24,1.9166666666666667,2.076923076923077,0,0,13,0,12,13,18,0.9953784385316868,2.090454496036687,0.5,11,14,12,12,0.8889686876112561,1.0374916331657276,1.2064913185660093,1.131370849898476,0.4971844555217912,4.906250255924486,1.66015625,27.48731469505522,-0.08,27,47,19,4.005116924927354,Humana
0,26,24,3,2,41,1.2380952380952381,1.1428571428571428,4,0,35,1,21,21,15,0.9988455357066628,4.953221174145164,0.84,5,3,21,20,0.9434164716336324,0.5259695722470125,0.3499271061118826,0.44923719676460017,2.328422309452173,6.578277307611251,7.800908976139378,45.26724533732937,0.04,27,47,13,3.2877416229161107,Humana
0,29,21,4,5,17,3.2222222222222223,2.3333333333333335,0,1,6,1,9,9,17,0.9814538947451146,1.3380582946942186,0.36,20,12,8,9,0.7858751946471527,1.227262335243029,1.4142135623730951,1.3966450099973928,-0.21198077002403926,4.0822628219461015,1.4646691235378944,18.751396186273166,0.16,24,50,18,3.8683670541566295,Humana
1,23,27,4,6,32,1.3529411764705883,1.6875,4,2,27,2,17,16,17,0.9953784385316868,3.7821158099666916,0.66,6,11,16,16,0.8889686876112561,0.8360394355030527,1.529654781315052,1.233895337666808,2.4331612566504344,6.752009848424895,7.867958256273999,47.05050357304815,-0.08,24,49,19,3.5482927579660557,Humana
1,19,31,3,5,28,1.3571428571428572,2.066666666666667,1,1,16,2,14,15,17,0.9580420219377606,2.50671099251589,0.58,5,16,14,14,0.6896598793878495,0.6102859818083951,1.18133634311129,1.0135819625309703,1.5651880349091976,5.181293083848168,5.043901105967077,30.193919467933327,-0.24,29,49,25,4.42292738033765,Aleatória
0,26,24,7,5,26,1.8571428571428572,1.8461538461538463,0,2,17,2,14,13,18,0.9988455357066628,2.4836263809196426,0.54,12,11,13,13,0.9434164716336324,1.5518257844571737,1.4595127662315595,1.5080943015927653,2.0665562312520054,5.93666594340229,6.525123646581038,38.79852748890852,0.04,28,49,24,4.441508966691419,Aleatória
0,40,10,13,1,20,3.6363636363636362,1.0,1,0,16,12,11,10,14,0.7219280945988233,2.245796072665548,0.42,29,0,10,10,0.3219280948873623,3.7964750941492906,0.0,3.0468749091516933,2.3536141920377687,6.673581963256285,7.72971049892738,46.32685294958394,0.6,21,48,10,2.9504200435222248,Humana
1,24,26,8,9,19,2.4,2.6,1,1,9,1,10,10,18,0.9988455357066628,1.4696938456699067,0.4,14,16,10,9,0.9434164716336324,2.1071307505705477,2.2891046284519194,2.202271554554524,1.9380176928166077,4.581453037427798,5.8481241364650876,24.895061728395067,-0.04,29,44,30,4.7059610761779505,Aleatória
0,30,20,4,2,36,1.5789473684210527,1.1111111111111112,3,0,29,2,19,18,17,0.9709505941661296,4.107602707176048,0.74,11,2,18,18,0.7369655941662062,0.9902572485382515,0.3142696805273545,0.778641096804753,2.390257496838413,6.530514263116234,7.878075192335614,44.833247584299464,0.2,25,49,18,3.636417710248888,Humana
-1,25,25,4,4,33,1.4705882352941178,1.4705882352941178,3,0,24,0,17,17,16,0.9999999997114609,3.4953683639925566,0.68,8,8,17,16,1.0,0.9772498662256559,0.7759356446042893,0.8823529411764706,2.0159999999999996,6.056470861708722,6.042488888888888,39.84427092751631,0.0,30,48,23,4.186044837897655,Humana
0,26,24,3,4,41,1.2380952380952381,1.1428571428571428,6,0,38,1,21,21,16,0.9988455357066628,5.319248067161372,0.84,5,3,21,20,0.9434164716336324,0.6098213559459856,0.63887656499994,0.6263307827602812,3.323284472047118,6.815360738570385,13.031541314444183,47.6362392768654,0.04,22,48,13,2.7396955123402753,Humana
1,18,32,3,4,27,1.2857142857142858,2.2857142857142856,0,0,14,1,14,14,17,0.9426831889669534,2.2992172581119865,0.56,4,18,13,14,0.6438561897747247,0.5890150893739515,0.9583148474999098,0.9394961741404219,0.9545323820796532,4.730992103558808,2.8481071870092545,25.65042885870232,-0.28,29,50,19,3.9437568590340324,Aleatória
0,28,22,6,4,23,2.3333333333333335,1.8333333333333333,1,0,12,2,12,12,18,0.9895875209335165,1.857309882599024,0.48,16,10,12,11,0.8365012677171205,1.6499158227686108,1.0671873729054748,1.411756195508118,1.2739381866931418,5.107242968694128,3.706212288603723,30.38318271312574,0.12,30,48,24,4.40651678246453,Aleatória
0,28,22,4,7,24,2.1538461538461537,1.8333333333333333,1,2,14,3,13,12,17,0.9895875209335165,2.090454496036687,0.5,15,10,12,12,0.8365012677171205,1.0262818510866412,1.9075871903765995,1.5231546211727816,1.7658451315617862,5.589315887271402,5.603448275862069,35.228885316464975,0.12,27,49,20,4.116408565770044,Humana
1,24,26,3,6,24,1.8461538461538463,2.1666666666666665,1,1,9,3,13,12,18,0.9988455357066628,2.0024984394500787,0.5,11,14,12,12,0.9434164716336324,0.6617173282340483,1.4624940645653537,1.131370849898476,1.823009670246568,4.438345805187829,6.933593749999999,21.662956076143807,-0.04,27,48,25,4.528465488430549,Aleatória
1,23,27,4,5,29,1.5333333333333334,1.8,1,1,17,1,15,15,17,0.9953784385316868,2.6758176320519307,0.6,8,12,15,14,0.8889686876112561,0.8055363982396383,1.1075498483890767,0.9775252199076786,1.7763573493184424,5.216178312098981,5.946457544618712,30.16756655535094,-0.08,29,47,26,4.517808423307222,Aleatória
1,21,29,5,6,26,1.6153846153846154,2.0714285714285716,2,2,18,1,13,14,18,0.9814538947451146,2.562888994864975,0.54,8,15,13,13,0.7858751946471527,1.146128032750103,1.6675167899898218,1.4581496062984833,1.6199316844486233,6.340811468853497,4.315791883454734,43.104162777895596,-0.16,33,49,29,4.68596793403569,Aleatória
1,23,27,4,4,35,1.2777777777777777,1.5,6,0,27,0,18,18,17,0.9953784385316868,3.8576676891614197,0.72,5,9,17,18,0.8889686876112561,0.7307192465536614,0.8333333333333334,0.7915448249319448,2.2162256279125394,6.369160959405699,7.158169331942053,43.14723222723248,-0.08,30,50,21,3.9525910320028728,Humana
-1,25,25,3,4,31,1.5625,1.5625,3,0,19,1,16,16,18,0.9999999997114609,2.9377542443165665,0.64,9,9,15,16,1.0,0.7880950133074057,0.7880950133074057,0.7880950133074057,1.325742839521275,5.343832090917059,4.078201020529251,31.83315103544784,0.0,29,50,18,3.9659806410190876,Aleatória
0,28,22,3,2,38,1.4,1.1578947368421053,4,0,32,1,20,19,16,0.9895875209335165,4.513490888436576,0.78,8,3,19,19,0.8365012677171205,0.8,0.36464227527765836,0.6384563896404477,2.0368087562911446,6.62376911456157,5.530894901144641,45.79093444527191,0.12,21,49,13,3.36435950969936,Humana
1,23,27,3,4,28,1.6428571428571428,1.8,2,0,18,1,14,15,18,0.9953784385316868,2.6690073060971575,0.58,9,12,14,14,0.8889686876112561,0.8949974347244049,1.1075498483890769,1.0135819625309703,0.9691171802562305,5.736609984732198,2.434702932098764,36.650345025173515,-0.08,30,49,24,4.441508966691418,Humana
1,17,33,5,11,19,1.7,3.3,1,2,9,6,10,10,17,0.924818704684491,1.4832396974191324,0.4,7,23,10,9,0.5994620704162712,1.268857754044952,2.72213151776324,2.2693611435820435,2.5797431795267642,4.589462336477055,10.010839852955035,24.64892561983472,-0.32,27,47,24,4.253858217870779,Humana
1,19,31,6,9,18,2.111111111111111,3.1,1,3,9,3,9,10,17,0.9580420219377606,1.398427688513067,0.38,10,21,9,9,0.6896598793878495,1.6629588385661962,2.5865034312755126,2.252729953582389,1.429583938496624,5.051894057434911,4.09087474495147,29.815327850379038,-0.24,24,45,22,4.197049999347146,Aleatória
1,20,30,4,6,22,1.6666666666666667,2.727272727272727,2,2,11,2,12,11,17,0.9709505941661296,1.722904524342542,0.46,8,19,11,11,0.7369655941662062,0.9428090415820634,1.6564424689353272,1.4341236958670123,1.108463598798866,4.924705389801575,3.3207720588235308,28.742747544040242,-0.2,30,48,26,4.5391225535538755,Aleatória
0,26,24,4,3,35,1.4444444444444444,1.3333333333333333,4,0,26,1,18,18,17,0.9988455357066628,3.752545802518606,0.72,8,6,17,18,0.9434164716336324,0.8314794192830981,0.5773502691896257,0.7179359990733382,1.9693106217186114,6.20285819614398,6.433396679694501,41.352425787108956,0.04,28,50,21,3.9690016298759927,Humana
0,29,21,4,5,33,1.7058823529411764,1.2352941176470589,3,1,26,1,17,17,17,0.9814538947451146,3.6684601674271997,0.68,12,4,16,17,0.7858751946471527,0.9557692240748189,0.9411764705882354,0.977249866225656,2.1623654589590595,6.580531072980338,6.901937618147444,45.3963541354439,0.16,26,50,19,3.87629157538707,Humana
0,28,22,5,3,30,1.8666666666666667,1.375,3,0,20,2,15,16,18,0.9895875209335165,2.924995726492605,0.62,13,6,15,15,0.8365012677171205,1.2036980056845192,0.6959705453537527,1.0057069205238642,1.7825392570350491,5.943964060354912,5.617410963775849,38.78237965908714,0.12,31,49,27,4.577697282049905,Aleatória
0,28,22,8,4,27,2.0,1.5714285714285714,3,0,20,4,14,14,18,0.9895875209335165,2.8506841284154936,0.56,14,8,13,14,0.8365012677171205,1.927248223318863,0.9793792286287207,1.5435844846410223,2.5166579807912246,6.37370758529763,9.786926438288953,43.29831532431407,0.12,28,50,19,4.0808548261309205,Humana
1,23,27,3,5,27,1.6428571428571428,1.9285714285714286,1,1,14,2,14,14,18,0.9953784385316868,2.3251666606933794,0.56,9,13,14,13,0.8889686876112561,0.8112726208286106,1.099628879881475,0.9767710236555246,1.3585242788329683,4.644232672605243,4.824530298264176,24.691578321651534,-0.08,32,48,26,4.51780842330722,Aleatória
0,28,22,12,4,23,2.3333333333333335,1.8333333333333333,2,0,14,8,12,12,18,0.9895875209335165,2.090358820872627,0.48,16,10,12,11,0.8365012677171205,2.981423969999719,1.1426091000668408,2.271502195073168,3.4591907772484554,5.618240065408203,15.21020960095934,35.44980150464691,0.12,27,37,26,4.420194836444763,Aleatória
1,22,28,4,6,24,1.8333333333333333,2.1538461538461537,1,2,12,2,12,13,18,0.9895875209335165,2.0124611797498106,0.5,10,15,12,12,0.8365012677171205,1.067187372905475,1.5613679330911108,1.3564659966250536,1.5385247598771874,4.762916811332885,4.513232514177694,25.19387288523091,-0.12,31,49,26,4.604764945046352,Humana
0,31,19,17,8,21,2.8181818181818183,1.7272727272727273,2,1,16,9,11,11,17,0.9580420219377606,2.27297162322806,0.44,20,8,11,10,0.6896598793878495,4.52906134802951,2.004127971368055,3.5442888526578042,3.419494724422496,6.439125354981746,13.872440270083114,43.95669883903818,0.24,22,25,20,3.7036628949641646,Humana
0,26,24,2,2,45,1.1304347826086956,1.0434782608695652,6,0,42,0,23,23,15,0.9988455357066628,5.895218401382597,0.92,3,1,22,23,0.9434164716336324,0.33678116053977536,0.20393111999232305,0.2817713347133852,2.931763649279748,6.766599740752967,9.595238095238093,47.15970783378104,0.04,19,50,10,2.5046919247392263,Humana
-1,25,25,4,4,29,1.6666666666666667,1.6666666666666667,2,0,18,0,15,15,17,0.9999999997114609,2.7129319932501073,0.6,10,10,15,14,1.0,0.8692269873603531,1.0749676997731399,0.9775252199076786,1.3481283454648894,5.545900970369796,3.6100594916170894,34.47849716446123,0.0,30,48,27,4.577697282049905,Aleatória
0,26,24,7,4,35,1.4444444444444444,1.3333333333333333,6,0,30,3,18,18,17,0.9988455357066628,4.20970307741532,0.72,8,6,18,17,0.9434164716336324,1.3833221775543036,0.816496580927726,1.1371938605810399,3.7317313106647942,6.728285578856719,17.367074691987394,46.809235619008916,0.04,26,47,22,3.7403463852733734,Humana
1,23,27,4,5,27,1.6428571428571428,1.9285714285714286,1,1,16,1,14,14,18,0.9953784385316868,2.409647277092646,0.56,9,13,13,14,0.8889686876112561,1.1088696211614302,1.099628879881475,1.1134612334371357,1.3606142146334381,5.50550798412307,3.890819488899049,34.2593679660668,-0.08,31,50,25,4.51205489055743,Aleatória
-1,25,25,6,5,28,1.6666666666666667,1.7857142857142858,2,2,19,1,15,14,18,0.9999999997114609,2.77913655655853,0.58,10,11,14,14,1.0,1.2995725793078614,1.3720980508784677,1.3364015431086966,2.0728048778075596,5.966279398894956,6.189101615068058,38.88900873944051,0.0,29,47,25,4.5071513581838945,Humana
1,23,27,5,5,26,1.7692307692307692,1.9285714285714286,2,1,17,0,13,14,18,0.9953784385316868,2.45120378589786,0.54,10,13,13,13,0.8889686876112561,1.186711432349347,1.386891988496257,1.2968252888897478,1.2952067118903434,6.095197505109482,3.3157405214373723,40.7137491567461,-0.08,30,49,22,4.251185325340039,Humana
1,3,47,1,21,5,1.0,15.666666666666666,0,8,3,20,3,3,12,0.32744491886593724,0.4749736834815167,0.12,0,44,3,2,0.08926733809708741,0.0,3.858612300930075,7.824463062870334,0.37591318287827336,4.825351326451351,1.5843524889575464,27.745435340274636,-0.88,17,37,6,1.3435664539866372,Humana
0,26,24,4,3,43,1.1818181818181819,1.0909090909090908,6,0,41,1,22,22,16,0.9988455357066628,5.736340296739725,0.88,4,2,22,21,0.9434164716336324,0.6492207662311683,0.41659779045053097,0.5473452081269224,4.226728560831731,6.839072590003074,20.22739595719382,47.85625270752323,0.04,19,48,14,2.5781952538557995,Humana
1,21,29,3,7,20,1.9090909090909092,2.9,0,1,6,4,11,10,18,0.9814538947451146,1.484452761121081,0.42,10,19,10,10,0.7858751946471527,0.7925270806437588,1.7578395831246945,1.430157849302972,1.558727282852608,3.9158750744870363,5.6714396684382065,17.961178363193262,-0.16,30,48,23,4.338141847079169,Aleatória
1,22,28,4,4,29,1.4666666666666666,1.8666666666666667,3,0,18,0,15,15,17,0.9895875209335165,2.6907248094147422,0.6,7,13,14,15,0.8365012677171205,0.8844332774281066,0.9568466729604883,0.9428090415820632,1.184403858487467,5.603041619555983,3.187500000000001,35.35353011202343,-0.12,31,50,26,4.51205489055743,Aleatória
-1,25,25,2,3,37,1.3157894736842106,1.3157894736842106,4,0,28,1,19,19,17,0.9999999997114609,4.057388322554299,0.76,6,6,18,19,1.0,0.46482951928041294,0.653140718210045,0.5668594533825794,1.6232333871683666,6.160202995453879,4.619203329369797,40.83646468739694,0.0,27,50,16,3.6697111438865004,Humana
0,26,24,3,3,27,1.8571428571428572,1.7142857142857142,2,0,11,0,14,14,16,0.9988455357066628,2.342306555513176,0.56,12,10,13,14,0.9434164716336324,0.8329931278350429,0.5890150893739515,0.7249208260780158,0.350126714376826,4.224414228601909,1.951267791497784,19.535003917744447,0.04,26,50,19,3.968653533549829,Aleatória
0,28,22,4,5,27,2.0,1.5714285714285714,1,1,19,1,14,14,18,0.9895875209335165,2.7288092641296866,0.56,14,8,13,14,0.8365012677171205,1.2535663410560174,1.1780301787479033,1.2351154618421845,1.2080786170773032,6.218289501649129,2.989552689567231,41.769227352750136,0.12,23,50,19,4.009458901888653,Humana
0,26,24,8,4,22,2.3636363636363638,2.0,0,0,8,4,11,12,18,0.9988455357066628,1.8023318229449314,0.46,15,12,11,11,0.9434164716336324,2.0123585110162416,0.816496580927726,1.5223601217401386,2.4408123895404024,4.440858722860525,9.636935191567161,21.850744058727187,0.04,30,48,29,4.691721466785482,Aleatória
0,26,24,5,3,30,1.7333333333333334,1.5,2,0,19,2,15,16,17,0.9988455357066628,2.8697735102268966,0.62,11,8,15,15,0.9434164716336324,1.18133634311129,0.7071067811865476,0.9731034276773133,1.8864716305719338,5.5877863294224035,6.272298031638693,34.53057973780991,0.04,31,49,24,4.457919564564537,Aleatória
0,26,24,6,5,21,2.3636363636363638,2.1818181818181817,0,2,8,1,11,11,18,0.9988455357066628,1.6019987515600629,0.44,15,13,11,10,0.9434164716336324,1.2984415324623362,1.5850541612875175,1.4517017656973918,1.2126649213248895,4.224180676162243,3.419838523644752,19.879599629355525,0.04,29,47,24,4.457919564564537,Humana
0,27,23,5,4,25,2.076923076923077,1.7692307692307692,1,0,14,1,13,13,18,0.9953784385316868,2.137662274541982,0.52,14,10,13,12,0.8889686876112561,1.4390989949130544,0.9730085108210398,1.2379597645716216,1.240820243149886,5.279426215499316,3.494864417644339,32.15928430195606,0.08,32,45,29,4.784431521274404,Aleatória
1,24,26,4,4,28,1.7142857142857142,1.7333333333333334,3,0,16,0,14,15,18,0.9988455357066628,2.5146769176178476,0.58,10,11,14,14,0.9434164716336324,0.9583148474999098,0.9977753031397177,0.9789703149364408,1.2352697090952625,5.135378871292205,3.3874138748468354,29.81520268516632,-0.04,29,48,28,4.631832608042797,Aleatória
1,23,27,3,5,24,1.7692307692307692,2.25,1,2,10,2,13,12,18,0.9953784385316868,1.9416487838947598,0.5,10,15,12,12,0.8889686876112561,0.7994080650317895,1.3616778865306827,1.131370849898476,1.3258252147247767,4.131138558983567,4.296875,19.029367687101153,-0.08,29,49,26,4.571943749300114,Aleatória
1,24,26,6,7,18,2.4,2.888888888888889,1,2,8,1,10,9,18,0.9988455357066628,1.3249905660041508,0.38,14,17,9,9,0.9434164716336324,1.624807680927192,2.1829869671542776,1.925193806123356,0.972043046935355,4.3865309290131815,2.641721463666405,23.350207215048748,-0.04,29,48,26,4.50988390207678,Aleatória
1,22,28,5,4,28,1.5714285714285714,1.8666666666666667,2,0,18,1,14,15,18,0.9895875209335165,2.6312734559524604,0.58,8,13,14,14,0.8365012677171205,1.1157499537009508,1.0873004286866725,1.110965771971518,1.464373329625194,5.907262264137539,4.113941884682639,38.59749964653876,-0.12,31,49,26,4.588354347173232,Aleatória
0,33,17,5,2,32,1.9411764705882353,1.0625,2,0,23,3,17,16,17,0.924818704684491,3.3142721674599995,0.66,16,1,16,16,0.5994620704162712,1.1098801331831298,0.24206145913796356,0.925111364998409,2.0224424800448277,6.183260306490882,6.984522647313452,41.36756819929422,0.32,23,49,17,3.794740490071568,Humana
0,27,23,2,1,46,1.125,1.0,7,0,44,1,24,23,15,0.9953784385316868,6.165744075129942,0.94,3,0,23,23,0.8889686876112561,0.33071891388307384,0.0,0.24444947432076722,3.568591947091803,6.809672786168891,13.734848484848477,47.57635099245687,0.08,17,49,6,2.081528658269844,Humana
-1,25,25,6,5,21,2.272727272727273,2.272727272727273,2,1,11,1,11,11,17,0.9999999997114609,1.7106723824274481,0.44,14,14,11,10,1.0,1.7104443383842527,1.3545149477955762,1.5427784316797402,0.9495609292496427,5.100159511889116,2.7506510416666665,30.083191913527287,0.0,29,46,22,4.311074184082723,Humana
-1,25,25,3,3,29,1.6666666666666667,1.6666666666666667,3,0,19,0,15,15,18,0.9999999997114609,2.925747767665559,0.6,10,10,15,14,1.0,0.8692269873603532,0.9428090415820635,0.9067647005823628,0.7054086239008155,5.442174504074383,1.5887509130752377,32.64791684863306,0.0,24,46,16,3.7691440342257594,Humana
0,29,21,6,4,26,2.0714285714285716,1.6153846153846154,2,0,17,2,14,13,18,0.9814538947451146,2.459349507491768,0.54,15,8,13,13,0.7858751946471527,1.5795245991068558,1.002954216185023,1.3527394346481239,1.6166092027204213,6.062745714548984,4.772751180631574,40.230414046747754,0.16,31,49,26,4.604764945046352,Aleatória
1,22,28,4,7,24,1.6923076923076923,2.3333333333333335,2,2,17,3,13,12,17,0.9895875209335165,2.4186773244895647,0.5,9,16,12,12,0.8365012677171205,1.1357556200179537,2.094967514996089,1.697056274847714,1.6204530402191715,6.369236627452688,4.5717592592592595,43.34407188253343,-0.12,34,49,23,4.273911011375185,Aleatória
0,28,22,7,5,22,2.3333333333333335,2.0,2,1,14,2,12,11,18,0.9895875209335165,2.0318464508914054,0.46,16,11,11,11,0.8365012677171205,2.0138409955990952,1.4142135623730951,1.7607353679405728,1.4072436518607312,6.016191967318108,3.891003866745985,39.627420860056006,0.12,28,47,24,4.412270315214323,Humana
-1,25,25,4,5,27,1.7857142857142858,1.7857142857142858,3,1,16,1,14,14,17,0.9999999997114609,2.4179330015531866,0.56,11,11,14,13,1.0,1.0126747770541304,1.1450871101343856,1.0809104250301114,1.2812378104893436,5.444349467554888,3.865849240098394,33.711292391180265,0.0,31,46,26,4.512054890557429,Aleatória
-1,25,25,3,3,29,1.6666666666666667,1.6666666666666667,0,0,14,0,15,15,18,0.9999999997114609,2.6000000000000005,0.6,10,10,15,14,1.0,0.5962847939999438,0.7888106377466154,0.699205898780101,0.5634097118269408,4.456986800182065,2.1694214876033064,21.563985854837004,0.0,27,46,22,4.221946673862942,Humana
-1,25,25,6,6,22,2.272727272727273,2.0833333333333335,2,2,13,0,11,12,18,0.9999999997114609,1.9205207627099479,0.46,14,13,11,11,1.0,1.7104443383842527,1.6562172428626492,1.685028032615313,1.2523410872880083,5.668360083955895,3.1402346804349626,36.49520481420682,0.0,23,49,22,4.284006521086277,Humana
0,30,20,5,3,25,2.3076923076923075,1.5384615384615385,2,0,16,2,13,13,17,0.9709505941661296,2.3852882425400916,0.52,17,7,12,13,0.7369655941662062,1.5384615384615383,0.8426500884694863,1.298611001241087,1.091168985345696,5.704936941135746,2.94230840258541,36.039516854543905,0.2,31,50,20,4.183371945366914,Humana
0,26,24,5,6,23,2.1666666666666665,2.0,0,1,10,1,12,12,18,0.9988455357066628,1.8137254478007416,0.48,14,12,11,12,0.9434164716336324,1.2801909579781012,1.35400640077266,1.3202482931462383,1.4761398988781291,4.35643737178531,4.622736147045284,21.170324777816447,0.04,28,50,24,4.42292738033765,Aleatória
0,28,22,3,3,38,1.4,1.1578947368421053,4,0,31,0,20,19,17,0.9895875209335165,4.392220395198765,0.78,8,3,19,19,0.8365012677171205,0.66332495807108,0.4880851839734581,0.5969459859909135,1.9726991729692795,6.529255093718543,5.584503206655685,44.839230090548725,0.12,28,48,16,3.5650826875320023,Humana
0,32,18,5,3,26,2.4615384615384617,1.2857142857142858,2,0,16,2,13,14,18,0.9426831889669534,2.351254984045754,0.54,19,4,13,13,0.6438561897747247,1.3931361750980642,0.5890150893739515,1.2081115874296362,1.1679036647877628,5.7841672583027455,3.055595991859347,37.526807865149614,0.28,30,49,24,4.376716575575198,Aleatória
0,26,24,6,4,27,1.8571428571428572,1.7142857142857142,2,0,18,2,14,14,18,0.9988455357066628,2.593530412391573,0.56,12,10,14,13,0.9434164716336324,1.5971914124998499,0.9583148474999098,1.3190132366156706,1.7989606833562866,6.136043420798668,5.422803381463865,40.972679388304016,0.04,30,48,28,4.637586140792589,Aleatória
0,26,24,5,4,24,2.0,2.0,0,0,10,1,13,12,18,0.9988455357066628,1.91049731745428,0.5,13,12,12,12,0.9434164716336324,1.2403473458920846,0.9128709291752769,1.0954451150103321,1.0954451150103324,4.2590932879258485,3.5,20.134546819290673,0.04,31,49,27,4.648243205915916,Aleatória
0,31,19,5,3,30,1.9375,1.2666666666666666,1,0,20,2,16,15,17,0.9580420219377606,2.958986312911907,0.62,15,4,15,15,0.6896598793878495,1.2975337182516684,0.573488351136175,1.0679319585320548,2.0885206310474818,5.815114917024388,6.785876977995634,37.238077473195304,0.24,27,49,24,4.3873736406985255,Aleatória
1,22,28,3,4,26,1.6923076923076923,2.0,1,0,14,1,13,14,18,0.9895875209335165,2.2199999999999998,0.54,9,14,13,13,0.8365012677171205,0.8213137116947161,1.1338934190276817,1.0075163339804032,0.7340223821660876,4.909815586221727,2.170628195763331,28.091591463139096,-0.12,28,49,23,4.4250983688183,Aleatória
1,24,26,3,4,31,1.5,1.625,2,0,20,1,16,16,16,0.9988455357066628,2.985029313088902,0.64,8,10,16,15,0.9434164716336324,0.7071067811865476,0.9270248108869579,0.8267972847076845,1.2932864367881443,5.669260561734397,3.6539102040816327,35.834293589868054,-0.04,29,48,26,4.561286684176786,Humana
0,26,24,5,9,19,2.6,2.4,1,1,9,4,10,10,18,0.9988455357066628,1.4696938456699067,0.4,16,14,10,9,0.9434164716336324,1.4966629547095767,2.3748684174075834,1.9874606914351791,1.7387494592591055,4.581453037427798,6.0575228328793465,24.895061728395067,0.04,29,40,25,4.395859717341203,Aleatória
0,28,22,4,4,27,2.0,1.5714285714285714,2,0,16,0,14,14,18,0.9895875209335165,2.4344198487524706,0.56,14,8,14,13,0.8365012677171205,1.0,0.9793792286287207,1.0126747770541304,0.8506257576324586,5.375072665472528,2.2831365560258403,32.94561247195255,0.12,33,46,26,4.507151358183894,Aleatória
1,24,26,3,4,38,1.2,1.368421052631579,5,0,31,1,20,19,15,0.9988455357066628,4.401317984422392,0.78,4,7,19,19,0.9434164716336324,0.5099019513592785,0.7405919620773835,0.6384563896404478,2.6279522720624504,6.502136854833672,10.041664932362131,44.49099951601163,-0.04,27,49,19,3.756165761575539,Humana
0,28,22,4,3,32,1.6470588235294117,1.375,3,0,20,1,17,16,17,0.9895875209335165,3.108761811396943,0.66,11,6,16,16,0.8365012677171205,0.8360394355030527,0.5994789404140899,0.7435057058415332,1.4963625750455725,5.350662107636657,4.939034889239633,31.589647749877816,0.12,28,48,24,4.204626424251423,Humana
1,19,31,3,7,29,1.2666666666666666,2.066666666666667,1,1,19,4,15,15,17,0.9580420219377606,2.821347195933177,0.6,4,16,14,15,0.6896598793878495,0.573488351136175,1.569146972791976,1.247219128924647,2.8138790755636687,5.775066379696046,11.693877551020416,36.71318906088228,-0.24,31,50,25,4.42868091308744,Aleatória
0,26,24,4,4,28,1.7333333333333334,1.7142857142857142,3,0,17,0,15,14,18,0.9988455357066628,2.554133904085689,0.58,11,10,14,14,0.9434164716336324,1.0624918300339485,0.9583148474999098,1.0135819625309703,1.1678074651405532,5.528328301367842,3.0430652006172845,34.60260773487656,0.04,27,46,20,4.1377226960166995,Humana
1,22,28,4,7,18,2.4444444444444446,2.8,0,3,6,3,9,10,17,0.9895875209335165,1.1981652640600127,0.38,13,18,9,9,0.8365012677171205,1.1653431646335017,1.98997487421324,1.661024614532579,1.0093776616787462,3.4931647688353413,3.3013862679634185,14.703120762870919,-0.12,26,48,23,4.33597085859852,Aleatória
0,30,20,5,2,30,2.0,1.25,1,0,19,3,15,16,17,0.9709505941661296,2.8697735102268966,0.62,15,4,15,15,0.7369655941662062,1.2110601416389966,0.4330127018922193,0.9731034276773134,1.8864716305719333,5.5877863294224035,6.27229803163869,34.53057973780991,0.2,30,48,22,4.25476786960918,Aleatória
0,30,20,5,5,27,2.142857142857143,1.4285714285714286,1,1,16,0,14,14,17,0.9709505941661296,2.4426215425235243,0.56,16,6,14,13,0.7369655941662062,1.1866605518454392,1.049781318335648,1.175862688082452,1.607182590510976,5.415307295368,4.632793671110144,32.90339206070485,0.2,29,46,23,4.281835532605627,Aleatória
-1,25,25,5,7,21,2.272727272727273,2.272727272727273,1,1,10,2,11,11,18,0.9999999997114609,1.6144348856488455,0.44,14,14,10,11,1.0,1.3545149477955762,1.813630667569091,1.6006197146962735,1.346069547165543,4.685125822130923,4.212154006243495,26.01343851711664,0.0,29,50,25,4.528465488430549,Aleatória
0,26,24,11,7,26,1.8571428571428572,1.8461538461538463,3,1,22,4,14,13,17,0.9988455357066628,3.0868106517893192,0.54,12,11,13,13,0.9434164716336324,2.587252896610691,1.7473564140923918,2.222839420462764,3.0396240356019715,6.717804472848132,11.745973533736116,46.722526542676576,0.04,26,39,17,3.663396055724472,Humana
-1,25,25,3,4,25,1.9230769230769231,1.9230769230769231,0,0,9,1,13,13,18,0.9999999997114609,2.0711349545599385,0.52,12,12,13,12,1.0,0.7297563831157798,0.9166442529086912,0.8284868934053083,0.5498823160673904,4.151981342398413,2.601516052318668,19.17328177717652,0.0,31,48,22,4.25693885808983,Aleatória
1,23,27,5,4,28,1.5333333333333334,1.9285714285714286,2,0,16,1,15,14,17,0.9953784385316868,2.5541339040856883,0.58,8,13,14,14,0.8889686876112561,1.0241527663824812,1.0326308782000686,1.0470501000475156,1.64980560816207,5.110615049364324,5.047080053265323,28.93654157793355,-0.08,29,48,26,4.472159173957006,Aleatória
0,28,22,6,4,30,1.8666666666666667,1.375,4,0,23,2,15,16,17,0.9895875209335165,3.2489382881181355,0.62,13,6,15,15,0.8365012677171205,1.4544949486180951,0.8569568250501305,1.209569887693721,2.086558168559081,6.541815796456293,6.778026098270165,45.0385208049565,0.12,29,49,24,4.303149662852282,Humana
1,16,34,3,5,25,1.2307692307692308,2.6153846153846154,4,2,17,2,13,13,17,0.9043814574359548,2.443276488652072,0.52,3,21,12,13,0.5563933485243853,0.5756395979652217,1.5951108733329016,1.3846153846153846,1.0941358024691354,6.175142194266965,2.6314014631915854,41.44398029620065,-0.36,26,50,18,3.861854088714682,Aleatória
0,26,24,5,4,27,1.8571428571428572,1.7142857142857142,1,0,16,1,14,14,18,0.9988455357066628,2.409647277092646,0.56,12,10,14,13,0.9434164716336324,1.1866605518454392,1.0301575072754254,1.1134612334371357,1.3606142146334381,5.50550798412307,3.890819488899049,34.2593679660668,0.04,32,47,27,4.631832608042797,Aleatória
0,26,24,3,3,41,1.2380952380952381,1.1428571428571428,5,0,37,0,21,21,16,0.9988455357066628,5.189836220922583,0.84,5,3,20,21,0.9434164716336324,0.6098213559459856,0.46656947481584343,0.5450249115361714,2.7324927634658556,6.762469253928943,8.923780665462381,47.13472800094301,0.04,22,50,16,3.03212852523934,Humana
0,26,24,2,2,46,1.0833333333333333,1.0434782608695652,7,0,44,0,24,23,15,0.9988455357066628,6.165744075129942,0.94,2,1,23,23,0.9434164716336324,0.2763853991962833,0.20393111999232305,0.24444947432076716,3.568591947091806,6.809672786168891,13.73484848484849,47.57635099245687,0.04,18,49,10,2.093795156461583,Humana
0,33,17,11,7,20,3.3,1.5454545454545454,1,1,14,4,10,11,17,0.924818704684491,1.990879202764447,0.42,23,6,10,10,0.5994620704162712,3.0347981810987035,1.7248787237282068,2.5907562873781793,2.0750439175324624,6.360596318783944,6.564127100073047,43.31420831168235,0.32,26,49,16,3.7507603251519113,Humana
0,28,22,4,5,27,2.0,1.5714285714285714,1,1,14,1,14,14,18,0.9895875209335165,2.3337523433303717,0.56,14,8,13,14,0.8365012677171205,0.9258200997725514,1.049781318335648,1.0126747770541304,1.4696454921471689,4.776696359334328,4.844657310462611,25.447407038929782,0.12,30,50,25,4.468576629687864,Aleatória
-1,25,25,5,3,28,1.7857142857142858,1.6666666666666667,2,0,17,2,14,15,18,0.9999999997114609,2.585265943766715,0.58,11,10,14,14,1.0,1.1450871101343858,0.8692269873603531,1.0135819625309703,1.3664977500248752,5.398232137304042,4.435538837448557,33.105906056370095,0.0,28,47,23,4.273911011375185,Humana
1,24,26,3,4,30,1.6,1.625,2,0,16,1,15,16,18,0.9988455357066628,2.777696887711113,0.62,9,10,15,15,0.9434164716336324,0.6110100926607788,0.8569568250501305,0.7482202261124645,1.2284818412384666,4.762624583161649,4.364111883473143,24.436249595403915,-0.04,29,49,24,4.414441303694972,Humana
1,20,30,4,6,25,1.5384615384615385,2.3076923076923075,2,2,14,2,13,13,18,0.9709505941661296,2.183941391154992,0.52,7,17,12,13,0.7369655941662062,0.8426500884694864,1.635407048113023,1.356553237580646,1.618548197082785,5.220436402148389,4.709060080023986,30.585879529314628,-0.2,33,50,27,4.631832608042798,Aleatória
0,29,21,6,3,22,2.6363636363636362,1.75,2,0,13,3,11,12,18,0.9814538947451146,1.9820191724602463,0.46,18,9,11,11,0.7858751946471527,2.1436047495548354,0.924211375534118,1.685028032615313,1.3613926815555566,5.345568289349194,3.6129572465297035,32.66158335622984,0.16,28,49,23,4.288910053459812,Humana
0,26,24,3,6,31,1.625,1.5,2,1,22,3,16,16,17,0.9988455357066628,3.1796855190411524,0.64,10,8,16,15,0.9434164716336324,0.6959705453537527,1.3693063937629153,1.0879309490955758,2.5334219245285463,6.152997064241323,9.681632519687613,40.89213599350117,0.04,28,46,21,4.108484044539603,Humana
0,27,23,5,3,25,2.076923076923077,1.7692307692307692,0,0,11,2,13,13,18,0.9953784385316868,2.032141727340886,0.52,14,10,12,13,0.8889686876112561,1.268647884805434,0.696568087549032,1.0348941574672084,1.1950198704857755,4.282352854663972,4.077561734989774,20.38734870100267,0.08,29,50,24,4.314656728351864,Aleatória
1,24,26,6,6,21,2.1818181818181817,2.3636363636363638,1,1,10,0,11,11,18,0.9988455357066628,1.6752313273097543,0.44,13,15,11,10,0.9434164716336324,1.5850541612875175,1.4316377952748744,1.5130288160993852,1.1856321677174424,4.5200381228794875,3.6674660167602875,23.766478705132673,-0.04,28,45,26,4.544876086303668,Aleatória
1,23,27,3,3,34,1.3529411764705883,1.5,3,0,23,0,17,18,18,0.9953784385316868,3.448187929913334,0.7,6,9,17,17,0.8889686876112561,0.5882352941176471,0.6871842709362768,0.6452337023220696,1.2242323417760133,5.686681597595519,3.3016147635524766,35.66226221439732,-0.08,28,49,22,4.265424934732508,Aleatória
1,0,50,0,50,0,0.0,50.0,0,10,0,50,0,1,10,-1.4426951601859516e-10,0.13999999999999999,0.02,0,49,0,0,0.0,0.0,0.0,0.0,0.0,6.857142857142859,0.0,48.02040816326532,-1.0,12,0,1,-0.0,Humana
1,23,27,5,6,26,1.6428571428571428,2.076923076923077,1,1,14,1,14,13,18,0.9953784385316868,2.308332731648538,0.54,9,14,13,13,0.8889686876112561,1.0424656799518874,1.4390989949130544,1.26794390878694,1.9146711434775145,4.939179702559334,6.086069727078941,26.732719152875013,-0.08,32,49,28,4.691721466785481,Aleatória
1,24,26,6,6,20,2.4,2.3636363636363638,0,2,9,0,10,11,17,0.9988455357066628,1.4844527611210807,0.42,14,15,10,10,0.9434164716336324,1.5620499351813308,1.7200807207658635,1.6468206157895793,1.042224083913072,4.502826393818683,2.829372713951745,24.216392483185892,-0.04,31,46,25,4.561286684176786,Aleatória
0,31,19,3,2,35,1.7222222222222223,1.0555555555555556,2,0,23,1,18,18,15,0.9580420219377606,3.600222215363935,0.72,13,1,17,18,0.6896598793878495,0.558326423395605,0.2290614236454256,0.541488574711609,0.9741394458745362,5.347725699243993,2.8876454293628826,31.262953907693056,0.24,19,50,11,2.887312318642715,Humana
0,32,18,7,5,18,3.5555555555555554,1.8,1,1,10,2,9,10,16,0.9426831889669534,1.4951922953252537,0.38,23,8,9,9,0.6438561897747247,2.586765939293959,1.32664991614216,2.2055080883954696,1.0896034042463154,5.473661204452473,2.666351876546926,34.52074348172788,0.28,30,49,25,4.251185325340038,Aleatória
1,23,27,3,8,24,1.9166666666666667,2.076923076923077,1,1,11,5,12,13,18,0.9953784385316868,1.9924858845171276,0.5,11,14,12,12,0.8889686876112561,0.8620067027323833,1.817078740156572,1.4422205101855958,2.8001692597908203,4.209771012722645,12.130177514792898,19.963485587751965,-0.08,28,48,26,4.501397825434101,Aleatória
-1,25,25,6,7,17,2.7777777777777777,2.7777777777777777,1,1,6,1,9,9,17,0.9999999997114609,1.2126005112979295,0.36,16,16,8,9,1.0,1.8724777273725242,1.8121673811444543,1.8425693279752222,0.8076118415126572,3.6597215278385535,2.509606611570248,15.283167231259792,0.0,28,50,20,4.120750542731343,Aleatória
0,30,20,7,3,24,2.3076923076923075,1.6666666666666667,2,0,13,4,13,12,17,0.9709505941661296,2.0420577856662137,0.5,17,8,12,12,0.7369655941662062,1.8138194034694763,0.7453559924999299,1.4422205101855958,1.9201160638565622,5.002712170947024,6.69378698224852,29.026706692200197,0.2,29,45,23,4.3873736406985255,Aleatória
0,32,18,7,3,20,2.909090909090909,1.8,1,0,10,4,11,10,18,0.9426831889669534,1.5632018423735305,0.42,21,8,10,10,0.6438561897747247,2.2342192231717286,0.8717797887081348,1.8120283419467094,1.2488530472526285,4.9392058021328475,3.34692164463844,28.93666399954493,0.28,29,49,24,4.280925880867226,Aleatória
0,27,23,4,3,27,1.9285714285714286,1.6428571428571428,0,0,13,1,14,14,17,0.9953784385316868,2.281753711512266,0.56,13,9,13,14,0.8889686876112561,0.9609731462195507,0.7178482586514923,0.8601138984851641,0.7628729597598728,4.387108528535713,2.602663495838287,21.70400479160628,0.08,30,50,25,4.484987227560984,Aleatória
-1,25,25,6,5,22,2.0833333333333335,2.272727272727273,1,1,10,1,12,11,17,0.9999999997114609,1.675828153481138,0.46,13,14,11,11,1.0,1.4409680388158819,1.3545149477955765,1.4034793383973019,1.1990800575019251,4.48051395542803,3.59396148702665,23.518050990780058,0.0,28,49,26,4.51205489055743,Aleatória
0,26,24,3,5,30,1.625,1.6,1,1,19,2,16,15,17,0.9988455357066628,2.8558011135231394,0.62,10,9,15,15,0.9434164716336324,0.6959705453537527,1.1430952132988166,0.9393690179716797,1.7732147329555419,5.578701231824481,6.183639640441441,34.855770831894155,0.04,30,48,23,4.370963042825407,Humana
0,27,23,4,3,21,2.4545454545454546,2.090909090909091,0,0,8,1,11,11,17,0.9953784385316868,1.6511813952440237,0.44,16,12,10,11,0.8889686876112561,1.233150906022776,0.899954085146515,1.0946904162538451,0.06872729367206,3.970865791726577,1.5810225921521996,17.813702638365385,0.08,29,50,22,4.197611554759383,Aleatória
0,27,23,6,6,21,2.4545454545454546,2.090909090909091,2,2,14,0,11,11,18,0.9953784385316868,2.011566553708825,0.44,16,12,10,11,0.8889686876112561,1.9241827716833388,1.8317674254190803,1.8873217720024267,1.064508366457729,6.169043944630369,2.468941274002616,41.36027255837038,0.08,27,50,19,4.104339944858224,Humana
0,49,1,26,1,2,24.5,1.0,0,0,1,25,2,1,11,0.14144054225328165,0.23748684174075835,0.06,47,0,1,1,0.029146345659516508,1.5,0.0,11.14550233153366,-0.6688778044849151,3.7054684526926827,1.5000000000000002,14.730496453900704,0.96,16,27,6,0.7483525606365471,Humana
0,27,23,3,2,42,1.2857142857142858,1.0454545454545454,4,0,37,1,21,22,15,0.9953784385316868,5.211564064654681,0.86,6,1,21,21,0.8889686876112561,0.5471012044321932,0.20829889522526548,0.4275529374616334,2.6707201048183755,6.67525512976874,9.656402086761666,46.258504806684996,0.08,21,49,14,3.1705438917629367,Humana
1,18,32,7,15,9,3.6,6.4,0,5,4,8,5,5,15,0.9426831889669534,0.7211102550927977,0.2,13,27,4,5,0.6438561897747247,2.8,5.2,4.404543109109048,0.898790814059876,4.160251471689221,2.9849080667446066,20.065088757396463,-0.28,22,50,17,3.233924727090664,Humana
0,26,24,4,3,24,2.0,2.0,1,0,10,1,13,12,18,0.9988455357066628,1.8788294228055935,0.5,13,12,12,12,0.9434164716336324,1.1094003924504583,0.816496580927726,0.9797958971132712,0.5103103630798288,3.9081654326028614,2.0833333333333335,17.419488158961233,0.04,30,49,24,4.457919564564537,Aleatória
1,23,27,4,5,29,1.5333333333333334,1.8,3,1,18,1,15,15,18,0.9953784385316868,2.705549851693737,0.6,8,12,14,15,0.8889686876112561,0.8844332774281066,1.1075498483890767,1.0110500592068732,1.669952720665417,5.588997543676208,5.302457466918714,34.85487772104271,-0.08,30,50,29,4.681064401662154,Aleatória
1,22,28,3,4,29,1.4666666666666666,1.8666666666666667,0,0,17,1,15,15,17,0.9895875209335165,2.6305892875931813,0.6,7,13,15,14,0.8365012677171205,0.7180219742846006,0.9568466729604881,0.869226987360353,1.0038218236384704,5.216967729128709,2.854671280276818,31.07270540278659,-0.12,29,47,22,4.294663586209604,Humana
1,18,32,18,32,1,18.0,32.0,0,6,0,14,1,1,14,0.9426831889669534,0.19595917942265428,0.04,17,31,0,1,0.6438561897747247,0.0,0.0,7.0,0.0,4.694855340334422,1.0,23.04166666666665,-0.28,14,50,6,1.4385857228739831,Humana
1,22,28,5,11,17,2.4444444444444446,3.111111111111111,1,2,9,6,9,9,18,0.9895875209335165,1.3676256797823005,0.36,13,19,9,8,0.8365012677171205,1.7069212773041351,3.034777840832814,2.484519974999766,1.9281166956385178,5.24365712262047,6.876167999999999,32.22436978663961,-0.12,26,46,19,4.05778104376961,Humana
0,26,24,9,6,17,2.888888888888889,2.6666666666666665,0,2,7,3,9,9,17,0.9988455357066628,1.179152237838694,0.36,17,15,8,9,0.9434164716336324,2.469567863432541,1.8257418583505538,2.1744873100867697,1.3883074704910816,4.25235779934618,4.296620741841583,22.089020751866148,0.04,31,50,25,4.398030705821852,Aleatória
0,29,21,7,4,22,2.6363636363636362,1.75,2,0,12,3,11,12,18,0.9814538947451146,1.8243903091169937,0.46,18,9,11,11,0.7858751946471527,2.185602778212965,0.924211375534118,1.710636136774435,1.5526679373463708,5.370200453655721,4.343248602848386,32.79833666384834,0.16,30,49,27,4.544876086303667,Aleatória
1,20,30,3,4,26,1.5384615384615385,2.142857142857143,1,0,14,1,13,14,17,0.9709505941661296,2.2199999999999998,0.54,7,16,13,13,0.7369655941662062,0.8426500884694863,1.0594569267279519,1.0075163339804032,0.7340223821660876,4.909815586221727,2.170628195763331,28.091591463139096,-0.2,29,49,25,4.4393379782107685,Aleatória
-1,25,25,4,4,28,1.6666666666666667,1.7857142857142858,3,0,19,0,15,14,17,0.9999999997114609,2.77913655655853,0.58,10,11,14,14,1.0,1.0110500592068732,1.263700429496724,1.141582438430817,1.2489783314569791,5.932736326800996,2.8838410410783757,38.772174992245446,0.0,25,48,19,4.05869069550801,Humana
0,28,22,3,2,37,1.4736842105263157,1.1578947368421053,3,0,29,1,19,19,17,0.9895875209335165,4.1403381504413375,0.76,9,3,19,18,0.8365012677171205,0.7517293082676684,0.36464227527765836,0.6115236862432762,1.7653153721231833,6.3841384703414965,4.84395061728395,43.33989853941377,0.12,22,47,15,3.576499185347487,Humana
-1,25,25,5,6,25,1.9230769230769231,1.9230769230769231,1,1,14,1,13,13,18,0.9999999997114609,2.247131504830102,0.52,12,12,12,13,1.0,1.3846153846153846,1.4390989949130546,1.4121199808219862,1.6933652312531111,5.049919274963724,4.684456145603111,28.360387842337854,0.0,27,50,25,4.517808423307221,Aleatória
0,27,23,5,4,20,2.7,2.090909090909091,0,0,9,1,10,11,18,0.9953784385316868,1.5374004032782091,0.42,17,12,10,10,0.8889686876112561,1.4866068747318506,1.1642044068059725,1.361938061530961,0.30766768716246473,4.262143688119766,1.5884499733980548,21.59232413669715,0.08,30,49,24,4.3873736406985255,Humana
0,31,19,6,5,24,2.3846153846153846,1.5833333333333333,0,1,11,1,13,12,17,0.9580420219377606,1.982422760159901,0.5,18,7,12,12,0.6896598793878495,1.3323467750529825,1.1149240133549712,1.296148139681572,1.6532501781652706,4.543750086414317,5.187074829931974,22.509857622904647,0.24,30,49,24,4.292492597728954,Aleatória
1,20,30,3,5,23,1.6666666666666667,2.5,1,2,8,2,12,12,17,0.9709505941661296,1.857309882599024,0.48,8,18,11,12,0.7369655941662062,0.74535599249993,1.2583057392117916,1.114924013354971,1.278573326260574,4.152034171806748,4.276177397709185,19.451044847016206,-0.2,32,50,23,4.430851901568091,Aleatória
1,21,29,4,4,24,1.6153846153846154,2.4166666666666665,0,0,12,0,13,12,17,0.9814538947451146,1.9416487838947598,0.5,8,17,12,12,0.7858751946471527,0.9230769230769231,1.1873172373979173,1.131370849898476,0.6629126073623883,4.622940768386373,1.953125,25.614934320230216,-0.16,30,49,25,4.51205489055743,Aleatória
0,28,22,5,3,28,2.0,1.4666666666666666,1,0,15,2,14,15,17,0.9895875209335165,2.4745908752761534,0.58,14,7,14,14,0.8365012677171205,1.0,0.8055363982396383,0.9430892642191272,1.5603085413193862,4.786371479760106,5.663966656181188,25.81752240638203,0.12,26,49,23,4.12615597915497,Humana
-1,25,25,5,4,27,1.7857142857142858,1.7857142857142858,2,0,16,1,14,14,18,0.9999999997114609,2.4179330015531866,0.56,11,11,14,13,1.0,1.1450871101343856,1.0126747770541304,1.0809104250301114,1.2812378104893436,5.444349467554888,3.865849240098394,33.711292391180265,0.0,33,48,30,4.795088586397731,Aleatória
0,27,23,5,3,33,1.588235294117647,1.3529411764705883,3,0,25,2,17,17,17,0.9953784385316868,3.5577520992896625,0.68,10,6,17,16,0.8889686876112561,1.1406305546861952,0.6809315825170721,0.9466751140841813,2.26859942367079,6.4189952372935695,7.641314232047821,43.714894229781486,0.08,26,48,21,4.205536075989825,Humana
-1,25,25,7,6,19,2.5,2.5,0,1,5,1,10,10,18,0.9999999997114609,1.4422205101855954,0.4,15,15,10,9,1.0,1.6881943016134133,1.3601470508735443,1.5329709716755893,1.623880522281973,3.7202248737220915,5.307831598008148,15.394230769230775,0.0,30,46,24,4.435755433941626,Aleatória
-1,25,25,1,1,49,1.0,1.0,8,0,50,0,25,25,14,0.9999999997114609,7.0,1.0,0,0,24,25,1.0,0.0,0.0,0.0,0.0,6.857142857142857,0.0,48.02040816326531,0.0,13,50,2,1.0,Humana
1,23,27,4,5,25,1.7692307692307692,2.076923076923077,1,1,11,1,13,13,18,0.9953784385316868,2.080769088582392,0.52,10,14,12,13,0.8889686876112561,0.890448992522325,1.2064913185660093,1.071414482860317,1.279001750609743,4.447293851613252,4.013975980444254,21.501067677477835,-0.08,32,50,27,4.594107879923024,Aleatória
1,23,27,8,6,22,2.090909090909091,2.25,1,1,10,2,11,12,18,0.9953784385316868,1.7912007146045918,0.46,12,15,11,11,0.8889686876112561,1.9284730395996752,1.479019945774904,1.7106361367744347,2.125916762130239,4.512889466068841,7.095642289125258,22.388294326072508,-0.08,30,46,26,4.544876086303667,Aleatória
0,34,16,8,3,24,2.8333333333333335,1.2307692307692308,1,0,16,5,12,13,17,0.9043814574359548,2.3086792761230392,0.5,22,3,12,12,0.5563933485243853,2.153807997220014,0.5756395979652217,1.7435595774162693,2.082853373298521,6.119334064045593,6.873268698060942,40.74647381630405,0.36,26,47,18,3.8976057056337257,Aleatória
1,23,27,4,7,25,1.7692307692307692,2.076923076923077,1,1,13,3,13,13,18,0.9953784385316868,2.1094074997496337,0.52,10,14,13,12,0.8889686876112561,0.9730085108210399,1.5913969896597848,1.327898192433236,2.2108060431181196,4.798414862436959,8.63154812846268,26.437212057314497,-0.08,32,43,30,4.762267390651492,Aleatória
0,31,19,6,6,16,3.4444444444444446,2.375,0,1,4,0,9,8,17,0.9580420219377606,1.1244554237496478,0.34,22,11,8,8,0.6896598793878495,1.9499920860871383,1.4947825928876748,1.8301587277769464,0.6626137737302188,3.6089092470949984,1.8878918789700154,15.907525389762394,0.24,27,49,23,4.251185325340038,Aleatória
1,24,26,4,6,27,1.7142857142857142,1.8571428571428572,4,1,19,2,14,14,16,0.9988455357066628,2.7141112725899803,0.56,10,12,14,13,0.9434164716336324,1.0973065354098013,1.5050933932646768,1.3190132366156708,1.6122041717366722,6.296573217212234,4.735089997506039,42.64441423655325,-0.04,30,43,24,4.3523814564716385,Humana
1,23,27,5,7,23,1.9166666666666667,2.25,2,2,14,2,12,12,16,0.9953784385316868,2.0517309765171454,0.48,11,15,12,11,0.8889686876112561,1.3202482931462383,1.920286436967152,1.6562172428626492,1.5181257183479862,5.829313188242387,4.297599743630827,37.89799413795775,-0.08,27,42,24,4.33379987011787,Humana
1,24,26,5,5,33,1.411764705882353,1.5294117647058822,5,1,27,0,17,17,18,0.9988455357066628,3.802315084261166,0.68,7,9,17,16,0.9434164716336324,1.0323487514578966,1.0910139406465533,1.0637141952955957,2.3494943594264313,6.634463694384726,7.540639115674882,45.92209970799995,-0.04,26,48,23,3.920331391668872,Humana
0,30,20,5,4,33,1.7647058823529411,1.1764705882352942,3,0,28,1,17,17,17,0.9709505941661296,3.9316154440636737,0.68,13,3,17,16,0.7369655941662062,1.3945023048387881,0.7058823529411764,1.143660123248446,2.313733829590309,6.708074156502084,6.76925338036449,46.631932511090874,0.2,26,44,18,3.592089449003067,Humana
0,28,22,6,3,27,2.0,1.5714285714285714,1,0,15,3,14,14,17,0.9895875209335165,2.3846173697262216,0.56,14,8,13,14,0.8365012677171205,1.4142135623730951,0.7284313590846836,1.1450871101343856,1.9951342886987706,5.05839214391822,7.306106072764157,28.811924804186788,0.12,29,50,26,4.588354347173232,Aleatória
0,27,23,6,6,20,2.7,2.090909090909091,0,1,7,0,10,11,18,0.9953784385316868,1.4572576985557497,0.42,17,12,10,10,0.8889686876112561,1.4177446878757827,1.443137078762504,1.4630753805464016,1.2386564660744381,3.5901439619544986,3.910419958345304,14.59886588417631,0.08,29,49,27,4.615422010169678,Aleatória
-1,25,25,2,3,38,1.25,1.3157894736842106,4,0,30,1,20,19,17,0.9999999997114609,4.295532563024053,0.78,5,6,19,19,1.0,0.4330127018922193,0.653140718210045,0.5523245956035387,1.8349420809090147,6.35089838041888,5.3645957193816916,42.91264047758127,0.0,26,49,17,3.7534332176826526,Humana
-1,25,25,4,5,32,1.4705882352941178,1.5625,4,1,23,1,17,16,17,0.9999999997114609,3.3142721674599995,0.66,8,9,16,16,1.0,0.9150793638884732,0.998044963916957,0.9573072120564433,2.1329007371499213,6.2030376513861265,7.11803767856354,41.42342237748664,0.0,28,49,22,4.080506729804756,Humana
0,26,24,6,4,26,2.0,1.7142857142857142,1,0,16,2,13,14,18,0.9988455357066628,2.3597457490161946,0.54,13,10,13,13,0.9434164716336324,1.5191090506254998,0.9583148474999098,1.26794390878694,1.587625313575768,5.744420146894249,5.073439993476917,37.03773517707372,0.04,30,47,26,4.571943749300114,Aleatória
1,21,29,4,4,22,1.75,2.6363636363636362,0,0,9,0,12,11,17,0.9814538947451146,1.6517869111964776,0.46,9,18,11,11,0.7858751946471527,0.924211375534118,1.1499191491521379,1.1287613031084496,0.38061367188702994,3.7715708732111706,1.7115277936760913,17.0006809089989,-0.16,27,49,23,4.2924925977289545,Aleatória
1,24,26,4,5,26,1.7142857142857142,2.0,2,1,15,1,14,13,18,0.9988455357066628,2.2645970944077445,0.54,10,13,13,13,0.9434164716336324,0.9583148474999098,1.3008872711759818,1.1451573950918745,1.1794794388305567,5.424128741760716,3.352475446858422,33.662272304364585,-0.04,27,49,24,4.377278130987435,Humana
0,27,23,6,5,25,2.076923076923077,1.7692307692307692,1,1,13,1,13,13,18,0.9953784385316868,2.1094074997496337,0.52,14,10,12,13,0.8889686876112561,1.3846153846153846,1.1200169060431566,1.2686478848054341,1.726728815745804,4.798414862436959,5.652843858131486,26.437212057314497,0.08,31,50,28,4.626079075293005,Aleatória
0,36,14,14,4,19,3.6,1.4,1,0,12,10,10,10,15,0.8554508102715916,1.7663521732655694,0.4,26,4,10,9,0.47393118833241243,3.8262252939417984,0.9165151389911681,2.9916550603303182,2.862711655370543,5.7833226974770096,11.05848756281015,37.3915187376726,0.44,25,35,22,3.930426901379963,Humana
0,27,23,4,3,36,1.4210526315789473,1.2777777777777777,2,0,27,1,19,18,17,0.9953784385316868,3.9182138787973275,0.74,8,5,18,18,0.8889686876112561,0.7480352843974682,0.558326423395605,0.6664231354561055,2.198393749024536,6.1417782584877125,8.006394996537402,40.588094422797106,0.08,26,48,21,4.0449529901656325,Humana
0,29,21,6,5,25,2.230769230769231,1.6153846153846154,1,1,16,1,13,13,18,0.9814538947451146,2.317239737273638,0.52,16,8,12,13,0.7858751946471527,1.671196998646187,1.1461280327501029,1.4655814525582809,1.5260092013592061,6.031095709119394,4.0719668510802975,39.942496388089005,0.16,32,50,29,4.7187891297819275,Aleatória
-1,25,25,4,6,23,2.0833333333333335,2.0833333333333335,0,1,10,2,12,12,18,0.9999999997114609,1.824719156473127,0.48,13,13,11,12,1.0,1.0374916331657278,1.4976833963009524,1.288302069478359,1.3646019574538013,4.2884404405985075,4.401551093293184,20.674184476329952,0.0,34,50,29,4.768020923401285,Aleatória
1,24,26,5,6,21,2.1818181818181817,2.3636363636363638,0,1,9,1,11,11,18,0.9988455357066628,1.538310761842353,0.44,13,15,11,10,0.9434164716336324,1.1922615498730909,1.610913195151759,1.4200453956193917,1.035839348309576,4.2170542652010985,3.2516124697661923,21.32122740681919,-0.04,31,46,28,4.631832608042798,Aleatória
-1,25,25,9,6,18,2.5,2.7777777777777777,0,2,6,3,10,9,17,0.9999999997114609,1.2944496900227525,0.38,15,16,9,9,1.0,2.247220505424423,1.6850834320114558,2.005532514027121,1.8426626172182794,3.695259692252104,6.014109919632084,15.445272750803378,0.0,28,49,22,4.257500413502067,Humana
1,22,28,4,5,21,2.0,2.5454545454545454,1,1,7,1,11,11,18,0.9895875209335165,1.5120846537148642,0.44,11,17,10,11,0.8365012677171205,1.044465935734187,1.233150906022776,1.1748043621200077,0.6366665398214991,3.6031061661482258,2.423285166194557,14.95568747150521,-0.12,31,50,23,4.316827716832514,Aleatória
1,19,31,4,7,25,1.4615384615384615,2.3846153846153846,2,2,16,3,13,13,17,0.9580420219377606,2.317239737273638,0.52,6,18,12,13,0.6896598793878495,0.9294650748918902,1.8203322409537277,1.517160224870463,1.848342523083672,6.031095709119394,5.847536032672264,39.942496388089,-0.24,31,50,25,4.43085190156809,Humana
0,32,18,8,4,24,2.4615384615384617,1.5,2,0,14,4,13,12,17,0.9426831889669534,2.1,0.5,19,6,12,12,0.6438561897747247,1.9460170216420796,0.9574271077563381,1.624807680927192,2.23802710871514,5.532879818594104,8.09228650137741,34.62253382078455,0.28,31,45,24,4.377278130987436,Aleatória
1,24,26,5,5,26,1.8461538461538463,1.8571428571428572,1,1,14,0,13,14,18,0.9988455357066628,2.237945486378075,0.54,11,12,13,13,0.9434164716336324,1.0986812966989,1.1866605518454392,1.1451573950918745,1.4754318863664027,4.898853528797393,4.539376936678279,27.68007635200978,-0.04,31,49,29,4.6859679340356895,Aleatória
0,27,23,10,6,27,1.9285714285714286,1.6428571428571428,2,2,22,4,14,14,18,0.9953784385316868,3.086486675817669,0.56,13,9,14,13,0.8889686876112561,2.3134478201002353,1.585971665083894,1.9884872724392937,2.968145633855642,6.700653581310416,11.38839875130073,46.56820874718715,0.08,27,48,18,3.9632480971262014,Humana
1,23,27,7,7,22,2.090909090909091,2.25,1,1,11,0,11,12,17,0.9953784385316868,1.7912007146045918,0.46,12,15,11,11,0.8889686876112561,1.6762808104168887,1.7380544678845176,1.710636136774435,1.8653491145012073,4.7216981155795335,5.678384712457183,25.904186664599596,-0.08,30,48,29,4.735199727655047,Aleatória
0,26,24,2,4,34,1.4444444444444444,1.411764705882353,2,0,22,2,18,17,17,0.9988455357066628,3.4770677301427426,0.7,8,7,17,17,0.9434164716336324,0.4969039949999533,0.7714633558002354,0.6452337023220694,1.8623960092975527,5.276400521642552,7.54036908881199,30.396597479203717,0.04,30,49,20,4.069347760631337,Humana
0,31,19,9,3,32,1.9375,1.1176470588235294,2,0,25,6,16,17,17,0.9580420219377606,3.5587076305872616,0.66,15,2,16,16,0.6896598793878495,1.919269066598011,0.4705882352941177,1.438037638509657,4.310615011887635,6.430532181316979,22.323444090747053,43.81235710633598,0.24,26,49,18,3.750000892459753,Humana
0,27,23,4,5,29,1.8,1.5333333333333334,1,1,20,1,15,15,18,0.9953784385316868,2.891366458960192,0.6,12,8,14,15,0.8889686876112561,0.9797958971132713,1.1469767022723505,1.0749676997731399,1.4967653068216984,6.115219209977727,4.315828402366862,40.65289256198343,0.08,29,50,22,4.259671401982716,Humana
0,27,23,3,2,39,1.35,1.15,4,0,31,1,20,20,17,0.9953784385316868,4.458699361921591,0.8,7,3,19,20,0.8889686876112561,0.57227615711298,0.3570714214271425,0.48733971724044817,1.7819624009900046,6.2935768313202445,5.332409972299169,42.23143691120566,0.08,27,50,18,3.7206120219364145,Humana
1,23,27,4,4,30,1.5333333333333334,1.6875,4,0,19,0,15,16,17,0.9953784385316868,2.8836782067352806,0.62,8,11,15,15,0.8889686876112561,1.0241527663824812,0.8454843286542927,0.9393690179716797,1.5397179724224814,5.516152381753276,4.307354708081171,33.87764249031253,-0.08,30,48,25,4.358134989221429,Aleatória
0,30,20,7,3,26,2.3076923076923075,1.4285714285714286,2,0,17,4,13,14,18,0.9709505941661296,2.4755605425842453,0.54,17,6,13,13,0.7369655941662062,1.9368735864637188,0.6226998490772391,1.4833321773704284,2.025524537636926,5.991245046261369,6.532930454412599,39.304238285738364,0.2,28,49,22,4.284006521086277,Aleatória
-1,25,25,3,3,19,2.5,2.5,0,0,2,0,10,10,18,0.9999999997114609,1.8761663039293717,0.4,15,15,9,10,1.0,0.6708203932499369,0.6708203932499369,0.6708203932499369,-0.9938079899999065,5.262181317322566,2.7777777777777777,30.82644628099175,0.0,21,50,10,3.2317537386100152,Humana
1,22,28,3,10,24,1.6923076923076923,2.3333333333333335,0,2,12,7,13,12,18,0.9895875209335165,2.0615528128088303,0.5,9,16,12,12,0.8365012677171205,0.8213137116947162,2.3921166824012206,1.7888543819998317,3.5218070645621684,4.519722706559429,16.062499999999996,23.039031141868513,-0.12,28,47,26,4.484987227560983,Aleatória
1,24,26,3,5,26,1.7142857142857142,2.0,1,1,13,2,14,13,17,0.9988455357066628,2.192806421004827,0.54,10,13,13,13,0.9434164716336324,0.7953949089757174,1.1766968108291043,1.0075163339804032,1.1685938358199142,4.47585532788308,4.15154857560263,23.128418433866695,-0.04,30,47,28,4.658900271039244,Aleatória
0,27,23,3,3,40,1.2857142857142858,1.15,4,0,34,0,21,20,15,0.9953784385316868,4.798708159494593,0.82,6,3,20,20,0.8889686876112561,0.5471012044321932,0.47696960070847283,0.518543698182178,2.3276597769916267,6.62011447744219,7.433021379904453,45.72522521199115,0.08,27,49,18,3.576528851506203,Humana
1,24,26,4,4,32,1.5,1.5294117647058822,2,0,20,0,16,17,17,0.9988455357066628,3.1724438529310497,0.66,8,9,16,16,0.9434164716336324,0.7905694150420949,0.7759356446042893,0.7832029080800053,1.842116323915845,5.216772462191675,6.303103374090144,29.883011040945913,-0.04,25,48,23,4.311074184082723,Aleatória
1,24,26,2,3,41,1.1428571428571428,1.2380952380952381,5,0,35,1,21,21,17,0.9988455357066628,4.953221174145164,0.84,3,5,21,20,0.9434164716336324,0.34992710611188255,0.5259695722470125,0.4492371967646002,2.328422309452172,6.578277307611251,7.800908976139373,45.26724533732937,-0.04,26,48,14,3.2517468807522754,Humana
1,24,26,4,4,20,2.4,2.3636363636363638,0,0,8,0,10,11,18,0.9988455357066628,1.5503547981026795,0.42,14,15,10,10,0.9434164716336324,1.2806248474865698,1.1499191491521379,1.2140522651411394,0.03898185332285137,3.788442401961837,1.4110437869822483,16.334245428329456,-0.04,30,46,24,4.398030705821853,Aleatória
1,11,39,5,21,6,3.6666666666666665,9.75,0,7,2,16,3,4,14,0.7601675026734266,0.4476605857119878,0.14,8,35,3,3,0.3584539709124763,1.8856180831641267,7.39509972887452,6.468132241526726,1.179085484256703,3.267017505536708,3.2634883997620467,12.746949215341765,-0.56,18,49,13,2.5025549957563205,Humana
0,32,18,6,2,29,2.1333333333333333,1.2,2,0,19,4,15,15,17,0.9426831889669534,2.863564212655271,0.6,17,3,15,14,0.6438561897747247,1.5434449203720302,0.4,1.2202003478482086,2.307752495707571,5.642976092112934,7.6620628202272165,34.987340868530616,0.28,24,48,17,3.9845622273728565,Aleatória
0,26,24,2,3,40,1.3,1.1428571428571428,3,0,33,1,20,21,17,0.9988455357066628,4.7018719676316145,0.82,6,3,20,20,0.9434164716336324,0.45825756949558394,0.4665694748158434,0.46915570882125235,2.036786905463753,6.452165626553264,6.405741417092767,43.9430187541438,0.04,22,49,13,3.313806727975609,Humana
1,21,29,3,7,23,1.75,2.4166666666666665,0,1,10,4,12,12,18,0.9814538947451146,1.8137254478007416,0.48,9,17,11,12,0.7858751946471527,0.7216878364870323,1.7057907908715602,1.3514395616855712,1.97554911826326,4.115087066427754,7.684092584828461,19.29671579054942,-0.16,29,50,24,4.441508966691418,Aleatória
1,24,26,9,7,22,2.1818181818181817,2.1666666666666665,2,1,15,2,11,12,18,0.9988455357066628,2.1467184258770406,0.46,13,14,11,11,0.9434164716336324,2.328408813611945,1.8633899812498251,2.098698849764725,1.9991060427744538,6.247191384037003,6.22127613328667,42.13740060426824,-0.04,27,46,21,4.205536075989824,Humana
0,29,21,4,3,26,2.0714285714285716,1.6153846153846154,1,0,12,1,14,13,18,0.9814538947451146,2.1467184258770406,0.54,15,8,13,13,0.7858751946471527,0.9609731462195508,0.737820234355803,0.890430761494171,0.6086616278522102,4.196623023743622,2.24137043378312,20.00040198611292,0.16,30,47,25,4.51205489055743,Aleatória
1,24,26,4,4,32,1.5,1.5294117647058822,3,0,23,0,16,17,17,0.9988455357066628,3.3021810973960837,0.66,8,9,16,16,0.9434164716336324,0.8660254037844386,0.9150793638884732,0.8917538769431613,1.620904135588418,6.239166242179293,4.4433886788024894,41.96143110071133,-0.04,29,49,26,4.517808423307222,Aleatória
0,29,21,4,2,26,2.230769230769231,1.5,1,0,11,2,13,14,18,0.9814538947451146,2.1560148422494687,0.54,16,7,13,13,0.7858751946471527,0.9730085108210399,0.5,0.8478165290562664,0.6511096071109452,4.136105347205992,2.5648854961832055,18.86304387205105,0.16,28,48,22,4.192708022385847,Aleatória
1,23,27,4,8,35,1.2777777777777777,1.5,4,1,31,4,18,18,17,0.9953784385316868,4.3406911892001725,0.72,5,9,18,17,0.8889686876112561,0.7307192465536614,1.6414763002993509,1.2753600314721105,4.145290914560145,6.785658100904682,20.626081539918413,47.361512514053075,-0.08,26,48,19,3.6249106447493045,Humana
1,23,27,3,10,31,1.4375,1.6875,2,2,25,7,16,16,17,0.9953784385316868,3.5313453526949177,0.64,7,11,15,16,0.8889686876112561,0.7043392293490403,2.1999644883497553,1.6381678027601445,4.303388503427423,6.571582720117553,22.059272960724115,45.29647536853034,-0.08,26,50,20,3.9033592383835165,Humana
0,28,22,4,3,35,1.5555555555555556,1.2222222222222223,1,0,25,1,18,18,16,0.9895875209335165,3.693453668316418,0.72,10,4,18,17,0.8365012677171205,0.7617394000445605,0.5328701692569688,0.6781419786518723,2.0101422157165185,5.900231268718566,7.230349984234948,37.8567810875472,0.12,26,48,20,3.9780492619309076,Humana
0,26,24,6,5,26,1.8571428571428572,1.8461538461538463,2,1,15,1,14,13,18,0.9988455357066628,2.308332731648538,0.54,12,11,13,13,0.9434164716336324,1.456862718169367,1.0986812966989,1.2968252888897478,1.8046702152903757,5.348945123872199,5.591385931250318,32.02978920015693,0.04,29,44,26,4.4992268369534525,Aleatória
0,26,24,5,8,27,1.8571428571428572,1.7142857142857142,2,1,19,3,14,14,17,0.9988455357066628,2.7288092641296866,0.56,12,10,14,13,0.9434164716336324,1.1866605518454394,1.8294640678379566,1.5435844846410225,2.633186439150562,6.218289501649129,10.153602428366392,41.769227352750136,0.04,28,47,24,4.335970858598518,Aleatória
-1,25,25,6,3,24,1.9230769230769231,2.0833333333333335,0,0,11,3,13,12,18,0.9999999997114609,1.9209372712298547,0.5,12,13,12,12,1.0,1.4915938022819475,0.759202798262025,1.2,1.527777777777778,4.283139485942258,5.555555555555555,21.082578711965983,0.0,30,47,23,4.325313793475193,Aleatória
1,24,26,7,5,28,1.7142857142857142,1.7333333333333334,2,1,20,2,14,15,18,0.9988455357066628,2.8501929759228593,0.58,10,11,14,14,0.9434164716336324,1.577908716741037,1.2364824660660938,1.4116889303764635,2.3341975850366032,6.356176877799252,8.05375054824249,43.14944733877833,-0.04,33,49,28,4.664653803789036,Aleatória
-1,25,25,5,6,22,2.272727272727273,2.0833333333333335,0,1,11,1,11,12,18,0.9999999997114609,1.7344739836619056,0.46,14,13,11,11,1.0,1.4200453956193917,1.4976833963009524,1.464126803520238,1.110367546499179,4.908224139639856,3.1532291929117333,28.32022784017539,0.0,33,49,26,4.604764945046352,Aleatória
0,29,21,3,2,40,1.380952380952381,1.05,4,0,34,1,21,20,16,0.9814538947451146,4.798708159494593,0.82,8,1,20,20,0.7858751946471527,0.6529194857524804,0.21794494717703372,0.518543698182178,2.3276597769916267,6.62011447744219,7.433021379904457,45.72522521199115,0.16,25,49,14,3.3995351678088936,Humana
-1,25,25,5,4,24,2.0833333333333335,1.9230769230769231,3,0,15,1,12,13,18,0.9999999997114609,2.2203603311174516,0.5,13,12,12,12,1.0,1.3819269959814167,1.2686478848054341,1.3266499161421599,0.8223036670302644,5.716960346322352,2.1177685950413223,36.624816395047915,0.0,22,46,18,4.006726357995767,Humana
1,22,28,8,4,24,1.6923076923076923,2.3333333333333335,2,0,13,4,13,12,18,0.9895875209335165,2.0420577856662137,0.5,9,16,12,12,0.8365012677171205,1.8557443202792028,0.9428090415820634,1.5231546211727816,2.4450163360086274,5.002712170947024,9.884066587395958,29.026706692200197,-0.12,28,49,24,4.279664544124977,Aleatória
0,29,21,5,3,28,1.9333333333333333,1.5,1,0,16,2,15,14,18,0.9814538947451146,2.5067109925158904,0.58,14,7,14,14,0.7858751946471527,1.1234866364235145,0.7319250547113999,0.9789703149364408,1.4557880333043716,5.089871299065421,4.987503771342719,29.694998762849277,0.16,32,48,27,4.631832608042798,Aleatória
-1,25,25,5,5,9,5.0,5.0,0,5,0,0,5,5,17,0.9999999997114609,1.4000000000000004,0.2,20,20,4,5,1.0,0.0,0.0,0.0,0.0,6.8571428571428505,0.0,48.02040816326525,0.0,17,50,10,3.3136088506956902,Humana
0,26,24,6,4,24,2.0,2.0,3,0,13,2,13,12,18,0.9988455357066628,2.080865204668481,0.5,13,12,12,12,0.9434164716336324,1.4142135623730951,1.0801234497346435,1.2649110640673518,1.3044395348194564,4.967732856912203,4.562499999999999,27.99217554096507,0.04,30,48,26,4.528465488430548,Aleatória
0,33,17,9,4,21,3.0,1.5454545454545454,1,0,12,5,11,11,17,0.924818704684491,1.8238420984284798,0.44,22,6,11,10,0.5994620704162712,2.3741027013091993,0.9875254992000196,1.9582417480489105,2.049152058838468,5.407103361743932,7.0567311979785945,33.07416846955085,0.32,29,46,24,4.3244041417367916,Aleatória
-1,25,25,6,5,26,1.7857142857142858,1.9230769230769231,3,1,17,1,14,13,18,0.9999999997114609,2.45120378589786,0.54,11,12,13,13,1.0,1.4725377234348789,1.2686478848054341,1.3798471118664561,1.6203081813053835,6.111493203786268,4.59065975134749,40.7525737052475,0.0,29,48,25,4.474330162437656,Aleatória
1,24,26,3,3,28,1.7142857142857142,1.7333333333333334,0,0,12,0,14,15,17,0.9988455357066628,2.4987196721521205,0.58,10,11,14,14,0.9434164716336324,0.6998542122237652,0.679869268479038,0.6896551724137931,0.42300000000000043,4.404909744991594,2.1300999999999997,21.007147224196746,-0.04,28,49,20,4.069347760631337,Aleatória
1,22,28,5,4,18,2.4444444444444446,2.8,0,0,2,1,9,10,18,0.9895875209335165,1.3840520221436765,0.38,13,18,9,9,0.8365012677171205,1.0657403385139377,0.9797958971132713,1.0367218738732742,0.4969439091723559,4.232409043546683,2.6208417472632584,21.1588869460147,-0.12,28,48,16,3.7819720878297365,Humana
0,26,24,4,7,26,2.0,1.7142857142857142,0,1,14,3,13,14,17,0.9988455357066628,2.3169807940507408,0.54,13,10,13,13,0.9434164716336324,0.7844645405527362,1.6659862556700857,1.3250773199998753,2.374424683607589,4.8885176880184416,9.059824218749998,26.338981858537633,0.04,29,43,24,4.169634240024535,Humana
0,27,23,4,5,28,1.8,1.6428571428571428,2,1,17,1,15,14,18,0.9953784385316868,2.554133904085689,0.58,12,9,14,14,0.8889686876112561,0.9092121131323905,1.1715156762040515,1.0470501000475156,1.469565738525242,5.542732206609343,4.512850494774632,34.6346397993039,0.08,30,48,28,4.648243205915916,Aleatória
0,31,19,7,6,20,2.8181818181818183,1.9,1,1,11,1,11,10,18,0.9580420219377606,1.6624078921853085,0.42,20,9,10,10,0.6896598793878495,2.289032420366213,1.5132745950421556,2.0113059125659882,1.3680406027261505,5.377130351714367,3.4027428663355384,33.27817291308945,0.24,29,49,27,4.498317185215052,Aleatória
0,28,22,4,5,24,2.3333333333333335,1.6923076923076923,0,1,10,1,12,13,17,0.9895875209335165,1.8894443627691184,0.5,16,9,12,12,0.8365012677171205,0.9428090415820634,1.065877420042386,1.0583005244258363,1.0124048384175728,4.047252713132071,3.571428571428571,18.39500506084787,0.12,26,48,24,4.3067322071214225,Aleatória
1,18,32,3,4,25,1.3846153846153846,2.4615384615384617,0,0,12,1,13,13,17,0.9426831889669534,2.032141727340886,0.52,5,19,13,12,0.6438561897747247,0.6249260311258431,1.0088366960464616,0.9970370305242862,0.6199688168119761,4.382448988930962,2.101615646258503,22.49439988615284,-0.28,26,46,22,4.0370284689351905,Aleatória
0,31,19,4,3,24,2.3846153846153846,1.5833333333333333,0,0,7,1,13,12,17,0.9580420219377606,2.0322401432901573,0.5,18,7,12,12,0.6896598793878495,0.737820234355803,0.6400954789890506,0.8,0.46875,4.482225620750296,2.734375,23.085232369305093,0.24,29,48,17,3.874682142318658,Aleatória
1,21,29,3,6,22,1.9090909090909092,2.4166666666666665,0,2,9,3,11,12,18,0.9814538947451146,1.69952934661335,0.46,10,17,11,11,0.7858751946471527,0.7925270806437588,1.6051133570215186,1.3072431633367745,1.3112486366522702,3.906494665583441,4.436408489310051,17.272629563855173,-0.16,30,47,25,4.501397825434102,Aleatória
1,24,26,4,4,27,1.7142857142857142,1.8571428571428572,2,0,15,0,14,14,18,0.9988455357066628,2.350829640786418,0.56,10,12,13,14,0.9434164716336324,0.9583148474999099,1.0594569267279519,1.0126747770541304,1.0569656691373621,5.078658933855018,2.86530036385238,29.647524131366367,-0.04,30,50,26,4.604764945046352,Aleatória
0,31,19,9,3,26,2.3846153846153846,1.3571428571428572,3,0,19,6,13,14,17,0.9580420219377606,2.743792995107321,0.54,18,5,13,13,0.6896598793878495,2.8430336327040506,0.6102859818083951,2.0852871496680367,2.941936366744175,6.172745777172371,10.250680771029664,41.120686252016654,0.24,25,49,19,3.716270044975116,Humana
0,32,18,5,4,30,2.0,1.2,1,0,23,1,16,15,17,0.9426831889669534,3.261226763044852,0.62,16,3,15,15,0.6438561897747247,1.2747548783981961,0.7483314773547881,1.1267257546176117,1.6124744568596108,6.481152835557264,4.295955388336468,44.3802839464513,0.28,26,49,18,3.7814105324174987,Humana
1,20,30,9,18,6,6.666666666666667,7.5,0,3,0,9,3,4,16,0.9709505941661296,0.6003332407921455,0.14,17,26,3,3,0.7369655941662062,2.0548046676563256,6.06217782649107,4.793703353017863,1.5069882878498049,5.4810845442457214,3.8678593174726856,34.43836235727721,-0.2,22,32,10,3.01612567505453,Humana
0,26,24,5,4,27,1.8571428571428572,1.7142857142857142,2,0,15,1,14,14,18,0.9988455357066628,2.350829640786418,0.56,12,10,14,13,0.9434164716336324,1.1248582677159729,0.9583148474999098,1.0473484499010846,1.3684295723142421,5.097132373578799,4.309983775013519,29.69278773148559,0.04,29,48,24,4.414441303694972,Aleatória
0,29,21,4,4,27,2.0714285714285716,1.5,2,0,15,0,14,14,18,0.9814538947451146,2.409647277092646,0.56,15,7,13,14,0.7858751946471527,1.1627728997214077,0.823754471047914,1.0473484499010846,1.1819120506358058,4.9394450015781874,3.0888263926446715,27.69540771840325,0.16,26,50,25,4.5120548905574305,Aleatória
0,29,21,4,2,36,1.6111111111111112,1.105263157894737,5,0,30,2,18,19,16,0.9814538947451146,4.227576137694033,0.74,11,2,18,18,0.7858751946471527,1.0076865081787252,0.30689220499185793,0.778641096804753,2.046748939923465,6.635765062172383,5.851104659602268,45.902687542197306,0.16,27,49,15,3.5037822730008252,Humana
1,16,34,4,10,20,1.6,3.090909090909091,1,3,12,6,10,11,17,0.9043814574359548,1.7673709288092299,0.42,6,23,10,10,0.5563933485243853,1.0198039027185568,2.609581835346786,2.148669366224472,2.1219241007576755,5.7403917278924,7.7781427430031504,37.044985870150796,-0.36,30,49,22,4.1398340331352035,Aleatória
1,22,28,4,8,24,1.8333333333333333,2.1538461538461537,1,2,12,4,12,13,18,0.9895875209335165,2.080865204668481,0.5,10,15,12,12,0.8365012677171205,0.8975274678557508,1.9940740610485723,1.5748015748023623,2.4580669741972354,4.728003121189899,9.144120707596255,24.22875475361221,-0.12,29,49,25,4.455748576083888,Aleatória
1,21,29,3,6,28,1.4,2.0714285714285716,1,1,17,3,15,14,18,0.9814538947451146,2.616027522790998,0.58,6,15,14,14,0.7858751946471527,0.6110100926607788,1.486332289048915,1.1713991552733123,2.0925439430449373,5.395563651176945,7.239400893283556,32.340623759161446,-0.16,27,47,20,4.118579554250693,Aleatória
0,26,24,7,4,18,2.888888888888889,2.4,1,0,8,3,9,10,18,0.9988455357066628,1.4681961721786365,0.38,17,14,9,9,0.9434164716336324,1.9688939051854832,1.2,1.6290302674254906,0.7509204662150872,4.027922176971817,3.277036362289216,18.4381604748627,0.04,26,47,17,3.882606663549099,Humana
0,27,23,4,3,24,2.25,1.7692307692307692,0,0,10,1,12,13,18,0.9953784385316868,1.8788294228055935,0.5,15,10,12,12,0.8889686876112561,1.0897247358851685,0.7994080650317895,0.9797958971132712,0.5103103630798288,3.9081654326028614,2.0833333333333335,17.419488158961233,0.08,28,48,22,4.305320651332932,Aleatória
0,26,24,2,2,45,1.1304347826086956,1.0434782608695652,6,0,42,0,23,23,15,0.9988455357066628,5.895218401382597,0.92,3,1,23,22,0.9434164716336324,0.33678116053977536,0.20393111999232305,0.2817713347133852,2.931763649279748,6.766599740752967,9.595238095238093,47.15970783378104,0.04,20,48,10,2.3266347815795863,Humana
-1,25,25,10,5,29,1.6666666666666667,1.6666666666666667,4,2,24,5,15,15,18,0.9999999997114609,3.382306905057553,0.6,10,10,15,14,1.0,2.2410315085295482,1.3498971154211057,1.8499249234015478,3.4001613851860966,6.626213629039893,14.442148760330586,45.825125923027976,0.0,23,39,18,3.7312690870597423,Humana
-1,25,25,4,5,37,1.3157894736842106,1.3157894736842106,4,1,32,1,19,19,17,0.9999999997114609,4.488028520408487,0.76,6,6,18,19,1.0,0.7981974151633211,0.9206766149755738,0.8616160812497317,3.04762619494059,6.74334741711146,11.706588327021601,46.953718672310444,0.0,27,50,19,3.59350100479156,Humana
1,18,32,3,6,23,1.5,2.6666666666666665,0,2,11,3,12,12,18,0.9426831889669534,1.8137254478007414,0.48,6,20,12,11,0.6438561897747247,0.7637626158259734,1.5456030825826172,1.3514395616855712,1.367832133390442,4.5977876771428665,4.236536598765344,24.640759606504247,-0.28,29,45,24,4.363038521594966,Aleatória
0,28,22,3,5,32,1.6470588235294117,1.375,2,1,22,2,17,16,17,0.9895875209335165,3.228683942413689,0.66,11,6,16,16,0.8365012677171205,0.6809315825170721,1.0532687216470449,0.8917538769431612,2.133685563976853,5.92600771124307,7.8586930433252125,38.47302624205555,0.12,23,49,20,3.9531525874151106,Humana
0,29,21,7,3,23,2.4166666666666665,1.75,1,0,11,4,12,12,18,0.9814538947451146,1.8247191564731269,0.48,17,9,12,11,0.7858751946471527,1.7539637649874327,0.82915619758885,1.411756195508118,1.807042445638673,4.525454657813354,6.601282035717317,24.06173634316661,0.16,33,48,25,4.51205489055743,Aleatória
1,23,27,4,4,29,1.5333333333333334,1.8,2,0,18,0,15,15,17,0.9953784385316868,2.6907248094147422,0.6,8,12,15,14,0.8889686876112561,0.8844332774281067,0.9797958971132713,0.9428090415820632,1.184403858487467,5.603041619555983,3.187500000000001,35.35353011202343,-0.08,30,48,28,4.675310868912363,Humana
0,30,20,5,3,26,2.142857142857143,1.5384615384615385,1,0,15,2,14,13,18,0.9709505941661296,2.2645970944077445,0.54,16,7,13,13,0.7369655941662062,1.3014905113063286,0.8426500884694863,1.1451573950918745,1.179479438830557,5.424128741760716,3.3524754468584232,33.662272304364585,0.2,26,47,22,4.278252988336485,Humana
0,28,22,3,5,34,1.6470588235294117,1.2222222222222223,4,1,28,2,17,18,18,0.9895875209335165,3.9661064030103885,0.7,11,4,17,17,0.8365012677171205,0.903664205631601,0.9162456945817024,0.9345958419312073,2.202818481484289,6.543109255618198,7.273779369377235,44.92612946782746,0.12,21,49,17,3.584012370211933,Humana
1,12,38,12,38,1,12.0,38.0,0,7,0,26,1,1,14,0.7950402790959832,0.19595917942265428,0.04,11,37,0,1,0.3959286763311392,0.0,0.0,13.0,0.0,4.694855340334422,1.0,23.04166666666665,-0.52,14,50,6,1.2415242038285013,Humana
-1,25,25,3,6,29,1.6666666666666667,1.6666666666666667,2,1,21,3,15,15,18,0.9999999997114609,3.013303834663873,0.6,10,10,14,15,1.0,0.8692269873603532,1.4452988925785866,1.1925695879998877,1.9609268005808702,6.262975037212065,6.628417968749999,42.10582390498549,0.0,28,50,20,4.1429146733542535,Humana
0,26,24,5,3,31,1.625,1.5,3,0,21,2,16,16,17,0.9988455357066628,3.077401501266938,0.64,10,8,16,15,0.9434164716336324,1.1110243021644486,0.7071067811865476,0.9333240326917549,1.8936367431974765,5.915226731193523,6.549357517746184,38.532345731405044,0.04,28,48,24,4.335970858598519,Humana
1,22,28,3,6,33,1.2941176470588236,1.6470588235294117,4,1,28,3,17,17,17,0.9895875209335165,3.9265251813785684,0.68,5,11,16,17,0.8365012677171205,0.6655122646461624,1.4528340041445258,1.143660123248446,2.5496791636593272,6.733562283869614,8.85659695977156,46.873941999362074,-0.12,25,50,18,3.750760325151911,Humana
1,24,26,8,7,26,1.7142857142857142,2.0,3,1,16,1,14,13,18,0.9988455357066628,2.483626380919642,0.54,10,13,13,13,0.9434164716336324,1.7899948694488095,1.5689290811054724,1.6932043630611051,2.750442857421024,5.357031515277208,9.649395847164675,31.657786135284272,-0.04,28,48,25,4.4144413036949715,Aleatória
0,29,21,11,10,18,3.2222222222222223,2.1,2,2,13,1,9,10,17,0.9814538947451146,1.8749933333214808,0.38,20,11,9,9,0.7858751946471527,3.9094693523909294,2.662705391138869,3.3593628204700945,1.8449374045489106,6.158833139436703,4.501372256841942,41.13496499085058,0.16,22,49,20,3.6623556225752485,Humana
0,28,22,7,5,27,2.0,1.5714285714285714,3,1,17,2,14,14,18,0.9895875209335165,2.554681976293723,0.56,14,8,14,13,0.8365012677171205,1.647508942095828,1.049781318335648,1.3978846993414948,2.346220947151275,5.6414999704223,8.218400834418395,35.109422143843204,0.12,27,42,26,4.528465488430548,Aleatória
1,24,26,4,4,24,2.0,2.0,1,0,9,0,12,13,18,0.9988455357066628,1.9313207915827966,0.5,12,13,12,12,0.9434164716336324,1.0,0.9607689228305228,0.9797958971132712,0.7654655446197433,4.156124495970569,2.6041666666666665,19.329004017853933,-0.04,30,48,26,4.5391225535538755,Aleatória
-1,25,25,4,6,26,1.9230769230769231,1.7857142857142858,2,1,14,2,13,14,18,0.9999999997114609,2.3341807984815577,0.54,12,11,13,13,1.0,1.2064913185660093,1.2637004294967238,1.2383891479481843,1.8037016015517466,4.799361891298051,5.7846925093045645,25.59281829992546,0.0,25,48,26,4.544876086303667,Humana
0,30,20,3,2,38,1.5,1.0526315789473684,2,0,31,1,20,19,17,0.9709505941661296,4.392220395198765,0.78,10,1,19,19,0.7369655941662062,0.7416198487095663,0.22329687826943603,0.5969459859909135,1.9726991729692789,6.529255093718543,5.584503206655684,44.839230090548725,0.2,23,49,14,3.4568716869083618,Humana
0,26,24,13,7,20,2.3636363636363638,2.4,2,1,13,6,11,10,18,0.9988455357066628,1.87712546197637,0.42,15,14,10,10,0.9434164716336324,3.4184719412660303,1.907878402833891,2.802655041821364,2.7478029304440392,6.075706413398066,10.212547136098653,40.42820189998305,0.04,26,49,21,4.038697553365749,Humana
0,27,23,3,4,36,1.4210526315789473,1.2777777777777777,4,0,29,1,19,18,17,0.9953784385316868,4.097853096439647,0.74,8,5,18,18,0.8889686876112561,0.7480352843974681,0.7307192465536614,0.7431203829658118,2.0981823334992447,6.567611325223351,6.427899554883688,45.247765598895974,0.08,26,49,20,3.7956501418099684,Humana
0,27,23,4,4,35,1.5,1.2777777777777777,5,0,29,0,18,18,17,0.9953784385316868,4.084311447478021,0.72,9,5,17,18,0.8889686876112561,1.0137937550497031,0.7307192465536614,0.8906233078822998,2.2242591997123533,6.641062234261911,6.501854683643962,45.97453048383628,0.08,25,50,20,3.7849930766866406,Humana
0,29,21,2,2,40,1.380952380952381,1.05,4,0,32,0,21,20,16,0.9814538947451146,4.628995571395592,0.82,8,1,20,20,0.7858751946471527,0.4856209060564557,0.21794494717703372,0.4139161645970035,1.3552879972742158,6.217234799462829,2.8368055555555554,41.36659017744225,0.16,21,48,11,3.068591916616865,Humana
0,26,24,5,6,26,2.0,1.7142857142857142,2,1,18,1,13,14,18,0.9988455357066628,2.586194114910944,0.54,13,10,13,13,0.9434164716336324,1.5191090506254998,1.4356965173029845,1.4833321773704284,1.6169949805685009,6.20131947081348,4.166415320800244,41.619050596687465,0.04,29,49,27,4.615422010169678,Humana
1,23,27,2,5,29,1.5333333333333334,1.8,1,1,16,3,15,15,17,0.9953784385316868,2.6907248094147422,0.6,8,12,14,15,0.8889686876112561,0.4988876515698588,1.2220201853215575,0.9428090415820632,1.9003494744388463,4.894653551999984,6.731250000000001,25.926162205060887,-0.08,32,50,23,4.335970858598519,Aleatória
0,31,19,6,6,24,2.3846153846153846,1.5833333333333333,1,1,17,0,13,12,18,0.9580420219377606,2.41039415863879,0.5,18,7,12,12,0.6896598793878495,1.820332240953728,1.440968038815882,1.697056274847714,1.424034489889575,6.422271845028685,3.414351851851852,43.925764528485225,0.24,27,44,21,4.162057815120258,Humana
-1,25,25,6,5,28,1.7857142857142858,1.6666666666666667,2,1,18,1,14,15,18,0.9999999997114609,2.683952309561406,0.58,11,10,14,14,1.0,1.3190132366156708,1.1925695879998877,1.2566115281578343,2.0941582629734867,5.733420013551248,6.691902398751636,36.148133745887314,0.0,28,49,24,4.430851901568091,Humana
0,26,24,4,4,32,1.5294117647058822,1.5,3,0,23,0,17,16,17,0.9988455357066628,3.3021810973960837,0.66,9,8,16,16,0.9434164716336324,0.9150793638884732,0.8660254037844386,0.8917538769431613,1.620904135588418,6.239166242179293,4.4433886788024894,41.96143110071133,0.04,27,49,25,4.277845240648176,Humana
0,29,21,4,2,29,1.9333333333333333,1.4,2,0,16,2,15,15,18,0.9814538947451146,2.630589287593182,0.6,14,6,14,15,0.7858751946471527,1.0624918300339485,0.4898979485566357,0.869226987360353,1.3083520397984556,4.920324378344289,4.022491349480971,26.757492732800948,0.16,29,50,22,4.376716575575199,Aleatória
1,23,27,9,12,19,2.3,2.7,2,2,12,3,10,10,18,0.9953784385316868,1.7435595774162693,0.4,13,17,10,9,0.8889686876112561,2.4103941586387903,3.2572994949804666,2.8722813232690143,2.3168153483558327,5.9632997665959815,7.347107438016529,39.30090027700832,-0.08,28,45,26,4.34172439134831,Aleatória
-1,25,25,7,5,17,2.7777777777777777,2.7777777777777777,1,2,7,2,9,9,18,0.9999999997114609,1.179152237838694,0.36,16,16,8,9,1.0,1.9309052441091963,1.6850834320114558,1.8121673811444545,0.6684601821452635,4.105971105253958,2.4010684606252473,21.27462488131669,0.0,29,50,24,4.398030705821853,Aleatória
0,28,22,8,3,37,1.4736842105263157,1.1578947368421053,5,0,33,5,19,19,17,0.9895875209335165,4.628433860389497,0.76,9,3,19,18,0.8365012677171205,1.5683857290264565,0.48808518397345807,1.172160918490531,4.956617490862908,6.757673677056548,27.95300305671176,47.085823626757026,0.12,23,47,16,3.1252463274165705,Humana
1,23,27,3,3,31,1.4375,1.6875,3,0,19,0,16,16,17,0.9953784385316868,2.930938416275579,0.64,7,11,16,15,0.8889686876112561,0.6091746465505602,0.8454843286542927,0.7473912964438374,0.9087553031825308,5.288928445273431,2.358110421047484,31.691317376601052,-0.08,31,48,22,4.292492597728954,Humana
-1,25,25,5,4,27,1.7857142857142858,1.7857142857142858,2,0,15,1,14,14,18,0.9999999997114609,2.3762154784446636,0.56,11,11,13,14,1.0,1.1450871101343856,1.0126747770541304,1.0809104250301111,1.4509152502568519,5.099359793186543,4.314353273202266,29.204723024808153,0.0,30,50,28,4.681064401662154,Aleatória
1,17,33,1,2,33,1.0,1.9411764705882353,0,0,18,1,17,17,15,0.924818704684491,3.337304301378585,0.68,0,16,17,16,0.5994620704162712,0.0,0.23529411764705885,0.4991341984846218,0.11785113019775736,4.722274414125932,1.0138888888888886,23.39209059376328,-0.32,14,48,3,1.5842854806601532,Humana
0,28,22,4,3,30,1.8666666666666667,1.375,3,0,19,1,15,16,17,0.9895875209335165,2.841760018017004,0.62,13,6,15,15,0.8365012677171205,1.0873004286866725,0.5994789404140899,0.9043771463791087,1.3624944200504339,5.642142279006842,3.803886719888121,35.52070002471883,0.12,28,48,22,4.216193141113152,Humana
0,28,22,19,11,15,3.5,2.75,1,2,10,8,8,8,17,0.9895875209335165,1.4620533505997653,0.32,20,14,7,8,0.8365012677171205,5.873670062235365,3.2691742076555053,4.768057780690163,2.5309101374709297,5.924302764350993,8.170513338293123,38.661390915773225,0.12,24,50,23,3.6919349258715553,Humana
1,24,26,5,4,26,1.7142857142857142,2.0,1,0,15,1,14,13,18,0.9988455357066628,2.2821919288263204,0.54,10,13,13,13,0.9434164716336324,1.2205719636167902,1.1094003924504583,1.1770554505237556,1.2426202430045528,5.379595323198948,3.3473953533967262,32.92096928770096,-0.04,32,48,27,4.631832608042798,Aleatória
0,27,23,11,10,9,5.4,4.6,0,2,0,1,5,5,16,0.9953784385316868,0.7745966692414834,0.2,22,18,4,5,0.8889686876112561,3.0066592756745814,2.727636339397171,2.898275349237888,1.2322599273970611,5.06069823904436,2.8401360544217686,30.14666666666668,0.08,26,50,12,3.392838728484299,Humana
0,36,14,5,3,22,3.0,1.2727272727272727,0,0,10,2,12,11,16,0.8554508102715916,1.8784035775093701,0.46,24,3,11,11,0.47393118833241243,0.9128709291752769,0.616575453011388,1.1666441621738033,0.48044405016558034,4.498273274169669,2.3022453703703722,21.864046787997438,0.44,21,45,16,3.345718271983446,Humana
-1,25,25,4,6,24,2.0833333333333335,1.9230769230769231,1,1,13,2,12,13,18,0.9999999997114609,2.0124611797498106,0.5,13,12,12,12,1.0,1.1873172373979173,1.3846153846153846,1.296148139681572,1.3226001425322165,5.116270763332852,4.336734693877552,30.461362597165067,0.0,32,44,28,4.708132064658601,Aleatória
1,24,26,4,4,25,1.8461538461538463,2.0,0,0,12,0,13,13,17,0.9988455357066628,2.0222759455623263,0.52,11,13,12,13,0.9434164716336324,1.0262818510866412,1.0377490433255416,1.0348941574672084,0.7786108846876392,4.439937765380638,2.344281310094319,23.103084338057577,-0.04,29,50,24,4.3873736406985255,Aleatória
1,23,27,7,7,18,2.5555555555555554,2.7,0,1,7,0,9,10,18,0.9953784385316868,1.2789057822998533,0.38,14,17,9,9,0.8889686876112561,2.165954298846436,1.7349351572897473,1.9523407358938325,1.2447397188784977,3.9108083345453517,3.300324922255271,18.177283074483434,-0.08,29,49,24,4.42292738033765,Aleatória
1,20,30,3,6,25,1.5384615384615385,2.3076923076923075,1,1,14,3,13,13,18,0.9709505941661296,2.1747643550509097,0.52,7,17,13,12,0.7369655941662062,0.7457969011409736,1.4876215081395165,1.2379597645716218,1.484090105205954,5.152870346181525,5.127398220062307,30.462135680554304,-0.2,31,46,26,4.5342190211803395,Aleatória
1,24,26,4,4,28,1.7142857142857142,1.7333333333333334,2,0,19,0,14,15,18,0.9988455357066628,2.7501999927278025,0.58,10,11,14,14,0.9434164716336324,1.0973065354098013,1.1234866364235143,1.110965771971518,1.1625997520180418,6.066137239435616,2.7276832949090637,40.32043162343365,-0.04,31,49,26,4.588354347173233,Aleatória
0,28,22,4,5,26,2.1538461538461537,1.5714285714285714,1,1,16,1,13,14,17,0.9895875209335165,2.351254984045754,0.54,15,8,13,13,0.8365012677171205,1.0986812966989,1.237179148263484,1.2081115874296362,1.1679036647877632,5.7841672583027455,3.0555959918593474,37.526807865149614,0.12,30,49,25,4.474330162437656,Humana
1,24,26,4,5,29,1.6,1.7333333333333334,4,2,22,1,15,15,18,0.9988455357066628,3.104834939252005,0.6,9,11,14,15,0.9434164716336324,0.9521904571390465,1.4817407180595246,1.2472191289246468,1.6799278063066683,6.549549366525291,4.365306122448981,45.14138875019365,-0.04,28,50,20,4.14564721724714,Humana
0,30,20,19,8,21,2.727272727272727,1.8181818181818181,2,1,17,11,11,11,17,0.9709505941661296,2.4096472770926454,0.44,19,9,10,11,0.7369655941662062,5.153831921112134,1.9917183909278768,3.933328664142534,3.6101071064025394,6.510465327170578,15.080266888560153,44.6392067179356,0.2,21,50,20,3.527417610774372,Humana
0,27,23,5,6,28,1.9285714285714286,1.5333333333333334,2,1,18,1,14,15,18,0.9953784385316868,2.661503334583672,0.58,13,8,14,14,0.8889686876112561,1.1627728997214075,1.2578641509408808,1.2288641159452043,2.0969942525684773,5.7825958369753865,6.991470022940049,37.063790517329416,0.08,28,48,24,4.370963042825407,Humana
0,26,24,4,6,29,1.7333333333333334,1.6,3,1,18,2,15,15,17,0.9988455357066628,2.7422618401604177,0.6,11,9,14,15,0.9434164716336324,0.9285592184789413,1.254325848148452,1.1055415967851332,2.313414316578477,5.495541142444607,8.75206611570248,33.48234495246715,0.04,31,50,25,4.410099326733673,Aleatória
0,27,23,9,6,20,2.7,2.090909090909091,1,1,8,3,10,11,17,0.9953784385316868,1.5374004032782094,0.42,17,12,10,10,0.8889686876112561,2.238302928559939,1.443137078762504,1.8892223261787975,2.23993859235298,3.8658642667946825,7.928361768186648,16.870171740226276,0.08,26,49,23,4.33597085859852,Humana
1,24,26,3,4,44,1.0909090909090908,1.1304347826086956,7,0,43,1,22,23,15,0.9988455357066628,6.0174745533321525,0.9,2,3,22,22,0.9434164716336324,0.4165977904505309,0.611793359976969,0.5258737584977435,4.70494355199313,6.845955065130839,23.939732142857185,47.918762342562616,-0.04,18,49,8,1.7653636126766976,Humana
1,23,27,4,7,26,1.6428571428571428,2.076923076923077,3,2,17,3,14,13,18,0.9953784385316868,2.459349507491768,0.54,9,14,13,13,0.8889686876112561,0.9715336077668174,1.8170787401565716,1.4581496062984833,2.049995082254172,6.062745714548982,6.8500720083246645,40.230414046747754,-0.08,29,49,27,4.571943749300114,Aleatória
1,23,27,3,3,30,1.4375,1.8,3,0,18,0,16,15,17,0.9953784385316868,2.792060171271386,0.62,7,12,15,15,0.8889686876112561,0.7043392293490403,0.8326663997864532,0.7901579815429605,0.8026161390519557,5.19539542390018,2.06126666666667,30.85152059513823,-0.08,29,49,24,4.457919564564537,Humana
1,24,26,7,6,34,1.3333333333333333,1.5294117647058822,5,1,31,1,18,17,17,0.9988455357066628,4.341658669218482,0.7,6,9,17,17,0.9434164716336324,1.3743685418725538,1.288758958835685,1.3370695950625817,3.2726298401700644,6.794845957357168,12.63604803903171,47.44440135369981,-0.04,24,49,17,3.26529774199937,Humana
0,36,14,11,7,9,7.2,2.8,0,1,2,4,5,5,15,0.8554508102715916,0.4898979485566356,0.2,31,9,5,4,0.47393118833241243,2.5612496949731396,2.2271057451320084,3.255764119219941,0.3824856387834035,2.449489742783179,1.9526521893912425,8.16666666666667,0.44,27,39,15,3.2818355326056268,Humana
1,21,29,3,7,27,1.5,2.0714285714285716,3,2,19,4,14,14,18,0.9814538947451146,2.7067323473147473,0.56,7,15,14,13,0.7858751946471527,0.7319250547113999,1.8694646183289145,1.448081066622378,2.140836136002863,6.3455471567552495,7.178201644555738,43.109726596837405,-0.16,28,46,19,4.031623032511564,Humana
1,24,26,6,6,20,2.1818181818181817,2.6,1,3,10,0,11,10,18,0.9988455357066628,1.5503547981026795,0.42,13,16,10,10,0.9434164716336324,1.526623238522424,1.9078784028338913,1.7313960916855087,0.9990634264623078,5.012132792651013,2.5478141357362096,29.79715972720901,-0.04,32,49,28,4.648243205915915,Humana
0,28,22,5,5,25,2.1538461538461537,1.6923076923076923,0,1,13,0,13,13,18,0.9895875209335165,2.0903588208726274,0.52,15,9,12,13,0.8365012677171205,1.0986812966989,1.2639751327042292,1.2064913185660093,1.3303582390870383,4.87876728151361,3.8364069006543695,27.30508311410511,0.12,30,50,23,4.354552444952288,Aleatória
1,23,27,3,6,27,1.6428571428571428,1.9285714285714286,2,1,18,3,14,14,18,0.9953784385316868,2.6012304780622575,0.56,9,13,13,14,0.8889686876112561,0.8112726208286104,1.5795245991068558,1.2637004294967236,1.6816145677982726,6.084713337173414,5.308628239545164,40.49157460386936,-0.08,30,50,23,4.305320651332932,Humana
0,33,17,5,3,26,2.5384615384615383,1.2142857142857142,0,0,14,2,13,14,17,0.924818704684491,2.237945486378075,0.54,20,3,13,13,0.5994620704162712,1.2162606385262997,0.5578749768504754,1.1451573950918745,1.4754318863664024,4.898853528797393,4.53937693667828,27.68007635200978,0.32,28,49,21,4.0449529901656325,Humana
1,23,27,4,6,23,1.9166666666666667,2.25,0,1,10,2,12,12,18,0.9953784385316868,1.8026646942789997,0.48,11,15,11,12,0.8889686876112561,1.0374916331657278,1.3616778865306827,1.2219065248845982,1.3481283454648896,4.078223283475646,4.987366143861547,19.078390559328913,-0.08,29,50,26,4.50988390207678,Aleatória
0,27,23,5,8,16,3.0,2.875,0,1,3,3,9,8,17,0.9953784385316868,1.050904372433572,0.34,18,15,8,8,0.8889686876112561,1.1547005383792515,2.1469455046647083,1.6967300119830537,1.3925841765209699,3.2174285266300577,5.132800943047338,12.332630821418158,0.08,28,47,22,4.2326037389862705,Humana
1,23,27,4,9,21,2.090909090909091,2.4545454545454546,1,1,8,5,11,11,18,0.9953784385316868,1.6267759526130205,0.44,12,16,11,10,0.8889686876112561,0.8999540851465151,2.270908363053963,1.7368157431402544,2.5963260598618683,4.093184475879541,10.429206230061924,18.801422369865865,-0.08,30,46,26,4.515637434826572,Aleatória
1,19,31,3,6,25,1.4615384615384615,2.3846153846153846,3,1,13,3,13,13,17,0.9580420219377606,2.0903588208726274,0.52,6,18,12,13,0.6896598793878495,0.7457969011409737,1.4432048491764398,1.2379597645716216,1.6057250362339883,4.87876728151361,5.354139025953695,27.30508311410511,-0.24,33,50,24,4.435755433941627,Aleatória
1,24,26,5,5,25,1.8461538461538463,2.0,0,1,12,0,13,13,17,0.9988455357066628,2.09990475974507,0.52,11,13,12,13,0.9434164716336324,1.166596222161777,1.1766968108291043,1.1741798094210576,1.4322705398788191,4.585486835373792,4.234541067251189,23.19696621805231,-0.04,30,50,25,4.490740760310775,Aleatória
0,29,21,5,3,23,2.4166666666666665,1.75,0,0,9,2,12,12,17,0.9814538947451146,1.8137254478007416,0.48,17,9,11,12,0.7858751946471527,1.4409680388158819,0.7216878364870323,1.1873172373979173,1.1831394849792052,4.1955371682136064,3.6218544492707894,19.566401932656046,0.16,32,50,26,4.571943749300114,Aleatória
0,26,24,4,4,33,1.5294117647058822,1.411764705882353,4,0,26,0,17,17,18,0.9988455357066628,3.673908001025611,0.68,9,7,17,16,0.9434164716336324,0.9772498662256559,0.9112901991076274,0.9466751140841813,1.8525935648885195,6.55207511678551,4.952982215530478,45.128044005673736,0.04,25,46,23,4.0520275110198165,Humana
1,23,27,3,6,39,1.15,1.35,4,1,35,3,20,20,16,0.9953784385316868,4.90713765855412,0.8,3,7,20,19,0.8889686876112561,0.47696960070847283,1.107925990308017,0.8587782018658834,4.470284693424247,6.768363014770421,23.879632289571962,47.18835884813627,-0.08,25,47,19,3.3686648616116193,Humana
0,28,22,10,9,26,2.0,1.6923076923076923,3,1,22,1,14,13,17,0.9895875209335165,3.0868106517893192,0.54,14,9,13,13,0.8365012677171205,2.449489742783178,2.1261961478592695,2.304644323867266,2.7952067859700294,6.717804472848133,9.358839794925212,46.7225265426766,0.12,22,40,20,3.7135375010822287,Humana
1,23,27,4,6,27,1.6428571428571428,1.9285714285714286,3,1,17,2,14,14,17,0.9953784385316868,2.49927989629013,0.56,9,13,13,14,0.8889686876112561,0.8949974347244049,1.486332289048915,1.2351154618421845,1.7767227307832385,5.816892719525646,5.778246328340846,37.665472492483524,-0.08,32,50,27,4.648243205915916,Humana
1,24,26,5,6,29,1.6,1.7333333333333334,1,1,19,1,15,15,18,0.9988455357066628,2.821347195933177,0.6,9,11,15,14,0.9434164716336324,1.083205120618128,1.2892719737209144,1.1925695879998877,2.3146797423337673,5.775066379696048,8.012695312500002,36.713189060882286,-0.04,30,48,27,4.637586140792589,Aleatória
1,20,30,6,6,16,2.5,3.3333333333333335,0,3,6,0,8,9,17,0.9709505941661296,1.0697663296253066,0.34,12,21,8,8,0.7369655941662062,1.8708286933869707,1.699673171197595,1.8301587277769467,0.374737374740391,3.7030368424570663,1.6621260501331876,17.4454412966822,-0.2,26,47,24,4.370963042825406,Aleatória
1,22,28,2,3,41,1.0476190476190477,1.3333333333333333,6,0,35,1,21,21,16,0.9895875209335165,4.953221174145164,0.84,1,7,21,20,0.8365012677171205,0.21295885499998,0.563436169819011,0.4492371967646002,2.328422309452172,6.578277307611251,7.800908976139373,45.26724533732937,-0.12,19,48,14,3.1896870335289416,Humana
1,24,26,3,4,38,1.2,1.368421052631579,4,0,33,1,20,19,15,0.9988455357066628,4.631587200949584,0.78,4,7,19,19,0.9434164716336324,0.5099019513592785,0.929659038560826,0.749314830574485,2.778895297881941,6.731306931490559,9.667422626131883,46.84144697211105,-0.04,24,49,18,3.5500227439219945,Humana
1,20,30,3,6,27,1.4285714285714286,2.142857142857143,2,2,18,3,14,14,18,0.9709505941661296,2.593530412391573,0.56,6,16,13,14,0.7369655941662062,0.7284313590846835,1.64130361329658,1.3190132366156706,1.7989606833562866,6.136043420798668,5.422803381463865,40.972679388304016,-0.2,30,50,25,4.468576629687863,Aleatória
-1,25,25,5,5,24,2.0833333333333335,1.9230769230769231,1,1,9,0,12,13,18,0.9999999997114609,2.2203603311174516,0.5,13,12,12,12,1.0,1.3819269959814167,0.9970370305242863,1.2,1.6666666666666665,4.70840741849559,4.861111111111112,24.41987006735268,0.0,29,48,25,4.463673097314328,Aleatória
1,22,28,5,6,22,2.0,2.3333333333333335,2,2,14,1,11,12,18,0.9895875209335165,2.051438519673451,0.46,11,16,11,11,0.8365012677171205,1.4142135623730951,1.7480147469502527,1.605755244575599,0.9759456991142357,5.860473417635995,2.567235833885159,38.14755810252756,-0.12,30,49,22,4.305320651332932,Humana
-1,25,25,4,6,28,1.6666666666666667,1.7857142857142858,3,1,20,2,15,14,17,0.9999999997114609,2.8501929759228593,0.58,10,11,14,14,1.0,1.0749676997731399,1.4725377234348789,1.2837593426887093,1.7954851930037377,6.345811421014633,5.403012812103724,43.12879056394449,0.0,28,46,22,4.25693885808983,Humana
0,26,24,5,5,24,2.1666666666666665,1.8461538461538463,0,1,14,0,12,13,17,0.9988455357066628,2.1095023109728985,0.5,14,11,12,12,0.9434164716336324,1.5723301886761007,1.2307692307692306,1.4142135623730951,1.1879393923933996,5.464838709905805,2.9,34.00795354121954,0.04,26,46,24,4.414441303694972,Aleatória
-1,25,25,4,3,29,1.6666666666666667,1.6666666666666667,3,0,16,1,15,15,18,0.9999999997114609,2.5922962793631448,0.6,10,10,15,14,1.0,0.9428090415820634,0.699205898780101,0.8299933065325822,1.0364120372935464,4.907397612187242,3.199791883454734,27.1768707482993,0.0,31,46,26,4.571943749300114,Aleatória
0,28,22,4,4,27,2.0,1.5714285714285714,0,0,16,0,14,14,17,0.9895875209335165,2.409647277092646,0.56,14,8,14,13,0.8365012677171205,1.1338934190276817,0.9035079029052513,1.0473484499010846,0.9953945289573692,5.454047712982627,2.5800108166576514,34.050934038368986,0.12,28,47,23,4.294663586209604,Humana
1,23,27,4,4,24,1.9166666666666667,2.076923076923077,1,0,10,0,12,13,17,0.9953784385316868,1.8788294228055935,0.5,11,14,12,12,0.8889686876112561,1.0374916331657278,0.9166442529086912,0.9797958971132712,0.5103103630798288,3.9081654326028614,2.0833333333333335,17.419488158961233,-0.08,27,48,24,4.4521660318147465,Aleatória
0,28,22,3,2,41,1.3333333333333333,1.0476190476190477,5,0,35,1,21,21,17,0.9895875209335165,4.953221174145164,0.84,7,1,20,21,0.8365012677171205,0.563436169819011,0.21295885499998,0.44923719676460017,2.328422309452173,6.578277307611251,7.800908976139378,45.26724533732937,0.12,23,50,14,3.1305209824293754,Humana
1,21,29,4,9,24,1.75,2.230769230769231,1,2,13,5,12,13,18,0.9814538947451146,2.118962010041709,0.5,9,16,12,12,0.7858751946471527,0.82915619758885,2.258448962446646,1.7435595774162693,2.762044690678474,4.982058584827308,10.87257617728532,27.362091457879664,-0.16,30,49,25,4.398030705821853,Aleatória
-1,25,25,4,3,29,1.6666666666666667,1.6666666666666667,1,0,16,1,15,15,18,0.9999999997114609,2.5922962793631448,0.6,10,10,14,15,1.0,0.9428090415820634,0.6992058987801011,0.829993306532582,1.0364120372935468,4.907397612187242,3.199791883454737,27.1768707482993,0.0,28,50,24,4.441508966691418,Humana
1,23,27,4,8,23,1.9166666666666667,2.25,1,1,14,4,12,12,17,0.9953784385316868,2.071134954559939,0.48,11,15,11,12,0.8889686876112561,1.1873172373979173,2.0052015692526606,1.656217242862649,1.9583541528680943,5.694557068568916,7.132837686268226,36.53560782001513,-0.08,30,50,27,4.62117554291947,Aleatória
0,31,19,6,3,25,2.3846153846153846,1.4615384615384615,2,0,15,3,13,13,18,0.9580420219377606,2.2202702538204666,0.52,18,6,12,13,0.6896598793878495,1.6426274233894325,0.7457969011409737,1.356553237580646,1.5261066136738668,5.691088552566561,4.5518036414015555,36.42521412293268,0.24,29,50,25,4.501397825434102,Aleatória
0,26,24,4,4,26,2.0,1.7142857142857142,1,0,15,0,13,14,18,0.9988455357066628,2.28219192882632,0.54,13,10,13,13,0.9434164716336324,1.1094003924504583,1.0301575072754254,1.0785347984119287,0.8279699559242026,5.319022753116405,2.202624377002492,32.659801906428726,0.04,32,48,24,4.441508966691418,Aleatória
0,26,24,7,5,20,2.3636363636363638,2.4,0,1,6,2,11,10,17,0.9988455357066628,1.5374004032782091,0.42,15,14,10,10,0.9434164716336324,1.6663911618021234,1.2806248474865698,1.4952684255340554,1.555116321405239,4.4602833987823045,5.1278240190249695,22.922362693781725,0.04,29,48,27,4.631832608042798,Aleatória
-1,25,25,4,3,30,1.5625,1.6666666666666667,3,0,18,1,16,15,17,0.9999999997114609,2.777696887711113,0.62,9,10,15,15,1.0,0.7880950133074057,0.8692269873603531,0.8299793761463617,1.1621082431583178,5.300148660581332,3.398713958434114,31.69690624732731,0.0,30,48,24,4.368792054344757,Aleatória
0,27,23,7,4,20,2.7,2.090909090909091,1,0,7,3,10,11,18,0.9953784385316868,1.4572576985557497,0.42,17,12,10,10,0.8889686876112561,1.7349351572897473,0.9958591954639383,1.430157849302972,1.4610530444585377,3.5901439619545,5.6389177044360626,14.59886588417632,0.08,31,47,23,4.370963042825407,Humana
0,28,22,9,2,34,1.6470588235294117,1.2222222222222223,5,0,27,7,17,18,17,0.9895875209335165,3.8845849199110067,0.7,11,4,17,17,0.8365012677171205,1.8768301333580961,0.41573970964154905,1.3582702084576814,4.93953911563106,6.286559940847797,27.600536455478114,42.16113919531189,0.12,24,48,18,3.5916484464783562,Humana
0,26,24,5,5,29,1.7333333333333334,1.6,3,1,19,0,15,15,18,0.9988455357066628,2.821347195933177,0.6,11,9,15,14,0.9434164716336324,1.0624918300339485,1.2,1.1352924243950933,1.908465713422786,5.775066379696046,5.689655172413792,36.713189060882286,0.04,30,47,24,4.360867533114316,Humana
-1,25,25,5,6,28,1.7857142857142858,1.6666666666666667,4,1,21,1,14,15,18,0.9999999997114609,2.980536864392052,0.58,11,10,14,14,1.0,1.2058530725810097,1.4452988925785863,1.3364015431086964,1.8127508396818284,6.455475755401187,5.325736124581345,44.09905426283003,0.0,25,49,20,4.083587370023807,Humana
0,26,24,5,5,28,1.8571428571428572,1.6,2,1,18,0,14,15,17,0.9988455357066628,2.6539781461044485,0.58,12,9,14,14,0.9434164716336324,1.3014905113063284,1.0198039027185568,1.1713991552733123,1.7063906100795796,5.82280856422504,4.897739457962514,37.47538939221976,0.04,27,49,23,4.308903195602073,Aleatória
-1,25,25,7,5,22,2.0833333333333335,2.272727272727273,1,1,11,2,12,11,18,0.9999999997114609,1.7687283567580412,0.46,13,14,11,11,1.0,1.846543317180028,1.28564869306645,1.605755244575599,1.5430042143061908,4.8588584755420205,4.597371883626733,27.172496451210506,0.0,29,48,28,4.697474999535274,Aleatória
1,24,26,7,10,20,2.4,2.3636363636363638,2,2,13,3,10,11,18,0.9988455357066628,1.87712546197637,0.42,14,15,10,10,0.9434164716336324,2.244994432064365,2.568081253059188,2.419684955411905,1.890119680016779,6.075706413398066,5.636602025222581,40.42820189998306,-0.04,28,48,21,4.1727148802435865,Humana
0,29,21,6,3,22,2.6363636363636362,1.75,0,0,8,3,11,12,18,0.9814538947451146,1.7112568480505783,0.46,18,9,11,11,0.7858751946471527,1.5534552264213692,0.82915619758885,1.3072431633367745,1.4280248199500898,4.246743852029608,4.552926031795757,20.045348716172587,0.16,29,49,20,4.183371945366914,Aleatória
1,23,27,5,8,20,2.090909090909091,2.7,2,3,14,3,11,10,18,0.9953784385316868,1.9908792027644473,0.42,12,17,10,10,0.8889686876112561,1.6211413181933643,2.6476404589747453,2.1925456063278745,1.2445174540296613,6.3605963187839425,3.0741509433962233,43.31420831168233,-0.08,26,49,20,4.050204618865331,Humana
0,27,23,3,3,36,1.4210526315789473,1.2777777777777777,4,0,27,0,19,18,16,0.9953784385316868,3.897742936623707,0.74,8,5,18,18,0.8889686876112561,0.6740130776245103,0.558326423395605,0.6245524328806131,1.573431635182039,6.196420149108264,4.230126667508309,41.342137492401264,0.08,26,48,18,3.6865294894479277,Humana
0,27,23,6,6,19,2.7,2.3,0,1,6,0,10,10,16,0.9953784385316868,1.3266499161421599,0.4,17,13,9,10,0.8889686876112561,1.5524174696260025,1.4177446878757827,1.5,1.0666666666666667,3.4536754015271103,3.3703703703703702,13.87603305785124,0.08,32,50,22,4.338141847079169,Aleatória
0,26,24,5,5,23,2.1666666666666665,2.0,0,1,11,0,12,12,18,0.9988455357066628,1.8026646942789997,0.48,14,12,11,12,0.9434164716336324,1.2801909579781012,1.2909944487358056,1.288302069478359,1.0138435011150218,4.6108337969211135,2.8587209607674935,25.05662889903685,0.04,29,50,27,4.648243205915916,Aleatória
-1,25,25,9,11,12,3.5714285714285716,4.166666666666667,1,4,7,2,7,6,17,0.9999999997114609,1.0547037498748166,0.26,18,19,6,6,1.0,3.4582052676886303,4.487637339278753,3.9777487611839675,0.8543006694559507,5.399308556869335,1.8272572974805452,33.663295819567765,0.0,22,41,18,3.451279406389451,Humana
1,23,27,5,6,21,2.090909090909091,2.4545454545454546,1,3,11,1,11,11,18,0.9953784385316868,1.7338973441354597,0.44,12,16,11,10,0.8889686876112561,1.443137078762504,1.827250112931071,1.656442468935327,1.0017641800263906,4.946750793413336,2.449303237044564,28.585270210140298,-0.08,28,46,23,4.32173124920605,Aleatória
0,35,15,4,6,18,3.5,1.6666666666666667,0,1,8,2,10,9,16,0.8812908989421536,1.4951922953252534,0.38,25,6,9,9,0.5145731728297583,0.9219544457292888,1.563471919941143,1.5630781478860523,0.2929671438735321,4.396672001681237,1.8530936183997415,21.2095723839107,0.4,20,46,14,3.3471334164496245,Humana
0,26,24,4,5,26,2.0,1.7142857142857142,1,1,13,1,13,14,18,0.9988455357066628,2.1744884455889846,0.54,13,10,13,13,0.9434164716336324,1.0377490433255416,1.0301575072754254,1.0436298373041015,1.275893743478224,4.637543106741935,4.16238603125456,24.463440874212278,0.04,27,48,25,4.395859717341203,Aleatória
1,21,29,5,5,22,1.75,2.6363636363636362,0,2,10,0,12,11,17,0.9814538947451146,1.69952934661335,0.46,9,18,11,11,0.7858751946471527,1.1636866703140785,1.431637795274875,1.372150768526913,0.9977339329793522,4.346509934012721,2.733584942178355,22.31953523591089,-0.16,31,48,26,4.528465488430549,Aleatória
0,29,21,6,5,22,2.6363636363636362,1.75,1,1,10,1,11,12,17,0.9814538947451146,1.7459667808981936,0.46,18,9,11,11,0.7858751946471527,1.7200807207658637,1.1636866703140785,1.5223601217401386,1.4796106027414941,4.373186822517374,4.1508173904712775,21.87054801182395,0.16,29,45,23,4.376716575575199,Aleatória
0,31,19,9,5,20,2.8181818181818183,1.9,1,1,10,4,11,10,17,0.9580420219377606,1.6011246047700347,0.42,20,9,10,10,0.6896598793878495,2.5873180855923104,1.2206555615733703,2.10387828898805,1.9462402538095087,4.822776505186316,5.975775161246973,27.11160167108779,0.24,28,47,30,4.610518477796142,Aleatória
1,24,26,2,2,32,1.411764705882353,1.625,0,0,16,0,17,16,17,0.9988455357066628,3.2348724858949236,0.66,7,10,16,16,0.9434164716336324,0.49215295678475035,0.4841229182759271,0.4997703788627467,-0.06063390625908319,4.702165185258984,1.0036764705882353,23.13515025566536,-0.04,16,48,8,2.736232270795423,Humana
1,22,28,3,4,26,1.6923076923076923,2.0,1,0,11,1,13,14,17,0.9895875209335165,2.1928064210048275,0.54,9,14,13,13,0.8365012677171205,0.8213137116947163,0.9258200997725514,0.8904307614941709,0.9234270523291039,4.362045343610441,3.1578465296153064,20.749252799780734,-0.12,29,48,22,4.305320651332932,Aleatória
0,26,24,6,4,28,1.8571428571428572,1.6,2,0,18,2,14,15,18,0.9988455357066628,2.6539781461044485,0.58,12,9,14,14,0.9434164716336324,1.456862718169367,0.8793937305515279,1.200475530036497,1.9771384395287908,5.822808564225041,6.611467829951319,37.47538939221977,0.04,30,49,30,4.745856792778374,Humana
0,26,24,5,6,24,2.0,2.0,0,1,11,1,13,12,18,0.9988455357066628,1.982422760159901,0.5,13,12,12,12,0.9434164716336324,1.2403473458920846,1.35400640077266,1.296148139681572,1.6532501781652706,4.543750086414317,5.187074829931974,22.509857622904647,0.04,30,48,26,4.561286684176786,Aleatória
0,28,22,3,3,36,1.4736842105263157,1.2222222222222223,4,0,28,0,19,18,17,0.9895875209335165,3.994045568092582,0.74,9,4,18,18,0.8365012677171205,0.7517293082676684,0.5328701692569688,0.6664231354561055,1.6504962353863444,6.387866643141425,4.228964681440443,43.43502900605748,0.12,27,49,18,3.6364177102488875,Humana
0,26,24,3,4,27,1.8571428571428572,1.7142857142857142,2,0,17,1,14,14,18,0.9988455357066628,2.5702918122267757,0.56,12,10,13,14,0.9434164716336324,0.989743318610787,1.0973065354098013,1.0473484499010846,0.8088770072789333,5.545556408892233,2.0711952406706318,34.26821979534908,0.04,26,50,20,4.1128260215009025,Humana
-1,25,25,3,5,31,1.5625,1.5625,2,1,20,2,16,16,17,0.9999999997114609,3.011710477452971,0.64,9,9,15,16,1.0,0.7043392293490403,1.0588171466310885,0.899218410621135,2.004558859775743,5.605313210565575,7.395575159280264,34.87336257409203,0.0,30,50,26,4.544876086303667,Aleatória
1,21,29,3,6,25,1.6153846153846154,2.230769230769231,1,3,15,3,13,13,18,0.9814538947451146,2.238213573366045,0.52,8,16,12,13,0.7858751946471527,0.8355984993230935,1.7608497141937842,1.4121199808219862,1.6114125611266006,5.597690944070591,4.5505287534450405,35.39233590063451,-0.16,31,50,26,4.561286684176785,Aleatória
1,22,28,4,7,33,1.2941176470588236,1.6470588235294117,4,1,27,3,17,17,16,0.9895875209335165,3.797051487667767,0.68,5,11,16,17,0.8365012677171205,0.7487012977269327,1.4927738282881788,1.1939872429520257,3.283514156445792,6.661391246993764,14.301453954189837,46.17695386079194,-0.12,23,50,20,3.757075413313939,Humana
0,28,22,4,2,39,1.4,1.1,4,0,32,2,20,20,15,0.9895875209335165,4.565084884205331,0.8,8,2,19,20,0.8365012677171205,0.7348469228349535,0.3,0.5809475019311126,2.964505771171109,6.429843881098958,13.065843621399175,43.70573715835117,0.12,23,50,16,3.5636711317435092,Humana
1,16,34,2,18,29,1.0666666666666667,2.2666666666666666,4,3,27,16,15,15,16,0.9043814574359548,3.778888725538237,0.6,1,19,15,14,0.5563933485243853,0.24944382578492943,4.234251868853445,3.058685265854523,5.06921933084578,6.815840420741645,27.107582331401872,47.64251582986134,-0.36,18,31,13,2.7102909882564257,Humana
0,26,24,6,3,26,2.0,1.7142857142857142,2,0,16,3,13,14,17,0.9988455357066628,2.359745749016194,0.54,13,10,13,13,0.9434164716336324,1.7097008285302207,0.7953949089757174,1.3250773199998753,1.7058316236946145,5.771817390010914,5.15675537109375,37.12875955379915,0.04,28,49,18,4.0529371627582185,Aleatória
1,24,26,3,3,31,1.5,1.625,1,0,18,0,16,16,18,0.9988455357066628,2.8966187184370678,0.64,8,10,16,15,0.9434164716336324,0.7071067811865476,0.6959705453537527,0.7043392293490403,0.8510238019439579,5.001207199555957,2.4441068882137764,28.021614328329015,-0.04,26,46,20,4.162057815120259,Aleatória
0,27,23,6,5,21,2.4545454545454546,2.090909090909091,1,1,10,1,11,11,18,0.9953784385316868,1.6019987515600629,0.44,16,12,10,11,0.8889686876112561,1.6160353486028343,1.378704626191191,1.5130288160993852,1.0281552277681443,4.6911783408495165,2.948363721669773,26.36276826636649,0.08,31,50,24,4.452166031814746,Aleatória
-1,25,25,7,4,24,2.0833333333333335,1.9230769230769231,2,0,14,3,12,13,18,0.9999999997114609,2.090454496036687,0.5,13,12,12,12,1.0,1.846543317180028,0.9970370305242863,1.469693845669907,1.7388353112349717,5.536772377167793,5.915637860082304,35.02780556006472,0.0,30,47,26,4.539122553553876,Aleatória
0,28,22,4,4,28,2.0,1.4666666666666666,2,0,16,0,14,15,17,0.9895875209335165,2.482659863936258,0.58,14,7,14,14,0.8365012677171205,0.9258200997725514,0.8844332774281066,0.9430892642191272,1.066992946112768,5.182302314130769,2.9944307815493727,30.73574051330212,0.12,28,49,24,4.311074184082723,Aleatória
1,22,28,6,6,21,2.0,2.5454545454545454,1,1,10,0,11,11,18,0.9895875209335165,1.6752313273097543,0.44,11,17,11,10,0.8365012677171205,1.5374122295716148,1.4373989364401722,1.5130288160993852,1.1856321677174422,4.5200381228794875,3.667466016760286,23.766478705132673,-0.12,28,41,23,4.40868777094518,Aleatória
1,20,30,6,6,19,2.0,3.0,0,2,9,0,10,10,17,0.9709505941661296,1.42828568570857,0.4,10,20,10,9,0.7369655941662062,1.61245154965971,1.61245154965971,1.6881943016134133,0.8105826748282315,4.752715344024483,2.4330563250230837,27.196078431372555,-0.2,29,46,22,4.32173124920605,Humana
0,33,17,9,5,26,2.357142857142857,1.3076923076923077,3,1,19,4,14,13,17,0.924818704684491,2.6997036874442353,0.54,19,4,13,13,0.5994620704162712,2.1582778471054467,1.0658774200423862,1.799253007628314,2.6638312930239834,6.408416006558515,9.96849324906636,43.7398982896156,0.32,24,47,20,3.995721196546275,Humana
-1,25,25,5,6,25,1.9230769230769231,1.9230769230769231,3,1,18,1,13,13,18,0.9999999997114609,2.570914234275426,0.52,12,12,12,13,1.0,1.4390989949130544,1.5423028965971863,1.4915938022819473,1.3138276752543858,6.3149660163244326,3.40970178813943,42.77725636458982,0.0,29,50,22,4.311074184082723,Humana
0,26,24,3,3,33,1.5294117647058822,1.411764705882353,3,0,21,0,17,17,17,0.9988455357066628,3.2461669704437575,0.68,9,7,16,17,0.9434164716336324,0.6960093862470137,0.5998846486579748,0.6523845003770246,1.0622108135228525,5.377551107900213,2.9599444774935537,32.07328209752826,0.04,27,50,19,3.971734173768879,Aleatória
-1,25,25,10,5,23,2.0833333333333335,2.0833333333333335,1,2,13,5,12,12,18,0.9999999997114609,2.0614557962760203,0.48,13,13,12,11,1.0,2.43099202430247,1.4409680388158819,1.998263134713633,2.7677659371290737,5.110517257133628,10.69159621928166,29.221494694894037,0.0,28,47,27,4.544876086303668,Aleatória
1,21,29,2,6,33,1.2352941176470589,1.7058823529411764,4,2,25,4,17,17,17,0.9814538947451146,3.6135301299421876,0.68,4,12,16,17,0.7858751946471527,0.42418250299576343,1.4456712620522951,1.0910139406465533,3.0647704174709802,6.198030512626263,11.995098702001082,41.22359304020675,-0.16,27,50,21,3.9854122277491113,Humana
0,29,21,4,3,27,2.0714285714285716,1.5,2,0,13,1,14,14,17,0.9814538947451146,2.281753711512266,0.56,15,7,13,14,0.7858751946471527,0.9609731462195507,0.6267831705280087,0.8601138984851641,0.7628729597598728,4.387108528535713,2.602663495838286,21.70400479160628,0.16,29,50,23,4.346627923721847,Aleatória
1,22,28,4,4,24,1.8333333333333333,2.1538461538461537,1,0,10,0,12,13,18,0.9895875209335165,1.9416487838947598,0.5,10,15,12,12,0.8365012677171205,1.0671873729054748,1.0262818510866412,1.0583005244258363,0.8099238707340581,4.131138558983567,2.4234693877551017,19.029367687101153,-0.12,27,49,23,4.414441303694972,Aleatória
0,26,24,4,3,26,2.0,1.7142857142857142,0,0,10,1,13,14,17,0.9988455357066628,2.2909386722476883,0.54,13,10,13,13,0.9434164716336324,1.0377490433255416,0.5890150893739515,0.8478165290562664,1.015764334576153,4.624187135531226,3.679986597517627,23.32473063340883,0.04,29,48,24,4.430851901568091,Aleatória
0,27,23,5,5,25,2.076923076923077,1.7692307692307692,2,1,14,0,13,13,18,0.9953784385316868,2.1469979040511427,0.52,14,10,12,13,0.8889686876112561,1.3278981924332358,1.186711432349347,1.2686478848054341,1.2746495440788157,5.28942767987033,3.4051146193771618,31.944201684762497,0.08,32,50,23,4.348798912202496,Humana
1,24,26,3,4,27,1.7142857142857142,1.8571428571428572,1,0,13,1,14,14,17,0.9988455357066628,2.281753711512266,0.56,10,12,14,13,0.9434164716336324,0.7953949089757174,0.9147320339189784,0.8601138984851641,0.7628729597598728,4.387108528535713,2.6026634958382866,21.70400479160628,-0.04,32,46,26,4.588354347173232,Aleatória
-1,25,25,4,4,28,1.7857142857142858,1.6666666666666667,1,0,17,0,14,15,17,0.9999999997114609,2.554133904085689,0.58,11,10,14,14,1.0,1.0126747770541304,0.9428090415820632,0.9789703149364407,1.0147513848861525,5.51392439612634,2.6883454734651404,34.52546008674873,0.0,26,49,20,4.069347760631337,Humana
1,24,26,3,6,21,2.1818181818181817,2.3636363636363638,0,1,5,3,11,11,18,0.9988455357066628,1.7106723824274481,0.44,13,15,11,10,0.9434164716336324,0.7158188976374373,1.3666633071248098,1.094690416253845,1.5240277371779454,3.9975073189352486,6.587919143876335,17.877793259140358,-0.04,29,45,21,4.288910053459812,Aleatória
-1,25,25,3,4,25,1.9230769230769231,1.9230769230769231,1,0,13,1,13,13,18,0.9999999997114609,2.2202702538204666,0.52,12,12,12,13,1.0,0.9166442529086912,1.071414482860317,0.9970370305242862,0.38713608338703387,4.682412867511628,1.5627125850340133,24.254631284434222,0.0,24,50,17,3.7669730457451096,Humana
0,28,22,5,3,27,2.0,1.5714285714285714,1,0,13,2,14,14,17,0.9895875209335165,2.367783773911799,0.56,14,8,14,13,0.8365012677171205,1.1338934190276817,0.7284313590846836,0.9767710236555246,1.5884644849221414,4.6076697854045925,5.497126025908662,22.803130570932627,0.12,27,48,25,4.457919564564537,Aleatória
1,24,26,6,4,30,1.6,1.625,2,0,21,2,15,16,18,0.9988455357066628,3.0455869713406645,0.62,9,10,15,15,0.9434164716336324,1.3063945294843617,0.9921567416492215,1.155000889675365,2.2992439482395604,6.09738801264958,8.014939848763996,40.298838785963234,-0.04,29,49,27,4.586183358692583,Aleatória
0,30,20,7,5,24,2.3076923076923075,1.6666666666666667,1,1,15,2,13,12,17,0.9709505941661296,2.1931712199461306,0.5,17,8,12,12,0.7369655941662062,1.9368735864637188,1.178511301977579,1.6492422502470643,1.8190171877724972,5.8810405593621216,5.298442906574394,38.37909154956973,0.2,30,49,27,4.542705097823018,Aleatória
0,29,21,8,5,34,1.6111111111111112,1.2352941176470589,3,1,30,3,18,17,17,0.9814538947451146,4.201190307520001,0.7,11,4,17,17,0.7858751946471527,1.6377114414426308,0.9411764705882354,1.3582702084576814,3.776555485523464,6.780919198146991,17.081212311065862,47.31720919034741,0.16,25,49,18,3.565021786006621,Humana
1,24,26,7,8,25,1.8461538461538463,2.0,2,2,20,1,13,13,17,0.9988455357066628,2.8159545450876866,0.52,11,13,12,13,0.9434164716336324,1.6569737868106167,2.3533936216582085,2.0366465069036503,2.153021925894144,6.621282313217341,6.057336065657171,45.80600617150049,-0.04,23,50,20,3.93800332628424,Humana
1,20,30,3,5,25,1.5384615384615385,2.3076923076923075,2,2,15,2,13,13,17,0.9709505941661296,2.2112439937736403,0.52,7,17,12,13,0.7369655941662062,0.7457969011409736,1.5876744185038687,1.298611001241087,1.1965447330733663,5.722442802837177,3.1295660203139417,36.940525547545285,-0.2,29,50,24,4.403784238571644,Aleatória
0,30,20,4,3,35,1.6666666666666667,1.1111111111111112,4,0,26,1,18,18,17,0.9709505941661296,3.752545802518606,0.72,12,2,17,18,0.7369655941662062,0.8164965809277259,0.4581228472908512,0.717935999073338,1.9693106217186125,6.20285819614398,6.4333966796945035,41.352425787108956,0.2,23,50,17,3.616837154635857,Humana
0,41,9,15,1,18,4.1,1.0,0,0,10,14,10,9,14,0.6800770454397409,1.4951922953252537,0.38,31,0,9,9,0.2863041851566411,3.806573262134856,0.0,3.1657796298573824,3.0960837039121807,5.473661204452471,12.320112630142082,34.52074348172787,0.64,23,48,9,2.9140163035068447,Humana
0,26,24,3,4,31,1.625,1.5,3,0,21,1,16,16,16,0.9988455357066628,3.064375956047169,0.64,10,8,16,15,0.9434164716336324,0.6959705453537527,1.0606601717798212,0.899218410621135,1.4888130626877125,5.975465150318411,4.097668557025835,39.17058239327142,0.04,26,45,19,3.968653533549829,Humana
1,23,27,5,5,26,1.7692307692307692,1.9285714285714286,3,1,16,0,13,14,18,0.9953784385316868,2.359745749016194,0.54,10,13,13,13,0.8889686876112561,1.309952797378954,1.1627728997214075,1.238389147948184,1.3356690440702208,5.7444201468942495,3.67104719966974,37.037735177073735,-0.08,29,49,28,4.658900271039244,Humana
1,21,29,4,5,26,1.6153846153846154,2.0714285714285716,1,2,15,1,13,14,18,0.9814538947451146,2.2821919288263204,0.54,8,15,13,13,0.7858751946471527,0.923076923076923,1.386891988496257,1.2081115874296362,1.419959254158745,5.379595323198948,4.013776216857934,32.92096928770096,-0.16,27,49,25,4.490740760310775,Aleatória
1,21,29,4,5,23,1.75,2.4166666666666665,1,1,10,1,12,12,18,0.9814538947451146,1.7690675509996787,0.48,9,17,11,12,0.7858751946471527,1.0897247358851685,1.1873172373979173,1.1873172373979173,0.8844157809984822,4.216182503730221,2.699337523356547,20.63245229402685,-0.16,28,50,23,4.403784238571644,Aleatória
-1,25,25,3,3,37,1.3157894736842106,1.3157894736842106,4,0,30,0,19,19,17,0.9999999997114609,4.249988235277833,0.76,6,6,18,19,1.0,0.653140718210045,0.653140718210045,0.6531407182100452,1.8366484439799242,6.525614975111436,4.824000674650021,44.82587693692079,0.0,29,50,20,3.960167456907151,Humana
0,27,23,5,4,37,1.4210526315789473,1.2105263157894737,5,0,31,1,19,19,16,0.9953784385316868,4.379771683546985,0.76,8,4,18,19,0.8889686876112561,0.9355994123490092,0.6942582083301536,0.8305123072662896,3.2144326442265663,6.5963010987307955,13.139933226883429,45.470218908996465,0.08,25,50,19,3.67370143584395,Humana
1,21,29,5,4,30,1.4,1.8125,3,0,20,1,15,16,17,0.9814538947451146,2.9522195040342107,0.62,6,13,15,15,0.7858751946471527,1.019803902718557,1.0135796712641785,1.037286141342808,1.8651894181831128,5.85342104717921,5.663018306028308,37.579685226185845,-0.16,29,47,22,4.265424934732509,Aleatória
0,30,20,6,6,14,3.75,2.857142857142857,0,3,6,0,8,7,17,0.9709505941661296,1.1180339887498951,0.3,22,13,7,7,0.7369655941662062,1.7853571071357126,2.166535841157586,2.022100118413747,-0.12005024923238544,4.198799005430003,1.267131379962193,19.875391999999984,0.2,23,45,16,3.812060739683088,Humana
1,22,28,5,6,20,2.2,2.5454545454545454,1,1,9,1,10,11,18,0.9895875209335165,1.4709180806557514,0.42,12,17,10,10,0.8365012677171205,1.2489995996796797,1.6713433009863852,1.4952684255340554,0.7859558146771433,4.4555765661478635,2.5966677501244613,24.24116776265027,-0.12,29,48,23,4.308903195602073,Humana
0,26,24,4,10,23,2.1666666666666665,2.0,2,2,13,6,12,12,18,0.9988455357066628,1.9823218709382187,0.48,14,12,12,11,0.9434164716336324,1.0671873729054748,2.48327740429189,1.9130400472081661,2.952042267649072,5.3135055060006655,12.366000669717591,32.42664411558744,0.04,28,45,24,4.308903195602073,Aleatória
1,17,33,3,8,23,1.4166666666666667,2.75,0,3,12,5,12,12,17,0.924818704684491,1.9518196638009364,0.48,5,21,11,12,0.5994620704162712,0.6400954789890506,2.0866640042581523,1.6811867501526676,2.131065500244835,4.86353894319063,7.240448176566114,26.77909782417539,-0.32,27,50,20,4.120750542731344,Aleatória
1,23,27,4,4,29,1.5333333333333334,1.8,3,0,19,0,15,15,17,0.9953784385316868,2.785677655436824,0.6,8,12,14,15,0.8889686876112561,0.9568466729604883,0.9797958971132714,0.9775252199076786,1.1340138435381126,5.872083558137959,2.879935100054083,38.241683494526484,-0.08,27,50,26,4.528465488430548,Humana
1,23,27,3,3,37,1.2105263157894737,1.4210526315789473,4,0,29,0,19,19,17,0.9953784385316868,4.1403381504413375,0.76,4,8,19,18,0.8889686876112561,0.5210260492953507,0.6740130776245105,0.6115236862432762,1.7653153721231836,6.3841384703414965,4.843950617283952,43.33989853941377,-0.08,27,48,22,3.9921386522771325,Humana
0,33,17,8,5,24,2.75,1.3076923076923077,1,1,15,3,12,13,16,0.924818704684491,2.211334438749598,0.5,21,4,12,12,0.5994620704162712,1.963203164898291,1.0658774200423862,1.7204650534085253,2.0736065289438037,5.803896327630145,6.802410518626735,37.322631638375555,0.32,25,49,20,4.007287913408003,Humana
1,24,26,5,4,23,2.0,2.1666666666666665,1,0,8,1,12,12,16,0.9988455357066628,1.7915356541246954,0.48,12,14,11,12,0.9434164716336324,1.1547005383792515,0.8975274678557508,1.0374916331657276,0.9524626622727693,3.9351547782481964,3.6111134235171694,17.254229832933888,-0.04,31,50,25,4.468576629687864,Aleatória
-1,25,25,6,3,27,1.7857142857142858,1.7857142857142858,1,0,17,3,14,14,17,0.9999999997114609,2.515233587561999,0.56,11,11,13,14,1.0,1.6115020246683542,0.7726181304565691,1.263700429496724,1.8939834178552692,5.7361669181965045,6.124886443670955,36.76903778889704,0.0,28,50,22,4.354552444952287,Aleatória
1,23,27,5,4,24,1.9166666666666667,2.076923076923077,0,0,10,1,12,13,18,0.9953784385316868,1.8894443627691184,0.5,11,14,12,12,0.8889686876112561,1.1873172373979173,0.9166442529086911,1.0583005244258363,1.0124048384175728,4.047252713132071,3.571428571428571,18.39500506084787,-0.08,31,49,26,4.561286684176786,Aleatória
-1,25,25,3,4,33,1.4705882352941178,1.4705882352941178,3,0,24,1,17,17,17,0.9999999997114609,3.455083211733113,0.68,8,8,16,17,1.0,0.6960093862470137,0.9772498662256559,0.8483650059915269,1.8261103815635849,6.21773229538571,5.363258136094674,41.62058083349597,0.0,26,50,20,4.0879293469851055,Humana
1,21,29,5,5,23,1.75,2.4166666666666665,1,1,12,0,12,12,17,0.9814538947451146,1.857309882599024,0.48,9,17,11,12,0.7858751946471527,1.1636866703140785,1.3819269959814167,1.3202482931462383,0.9329606515907767,5.051054215936047,2.620482214568023,30.13874040086604,-0.16,31,50,26,4.484987227560983,Aleatória
1,17,33,3,6,24,1.4166666666666667,2.5384615384615383,2,1,12,3,12,13,18,0.924818704684491,1.9416487838947598,0.5,5,20,12,12,0.5994620704162712,0.6400954789890506,1.4472990555559062,1.2649110640673518,1.4230249470757703,4.721301210266934,4.749999999999999,26.12151636893245,-0.32,31,47,23,4.365209510075615,Aleatória
0,30,20,13,6,18,3.0,2.2222222222222223,1,2,12,7,10,9,18,0.9709505941661296,1.719185853827328,0.38,20,11,9,9,0.7369655941662062,3.5496478698597698,1.8724777273725242,2.905720787756266,2.401125261235303,6.202390092734994,8.718865604397871,41.77568597184472,0.2,25,47,21,4.065765216362195,Aleatória
0,27,23,10,5,19,2.7,2.3,1,1,7,5,10,10,18,0.9953784385316868,1.4142135623730947,0.4,17,13,9,10,0.8889686876112561,2.6095976701399777,1.2688577540449522,2.0615528128088303,2.396822647417879,4.106876185131471,8.99446366782007,19.047200000000007,0.08,31,50,28,4.604764945046352,Aleatória
0,27,23,6,5,27,1.9285714285714286,1.6428571428571428,3,1,19,1,14,14,18,0.9953784385316868,2.7141112725899803,0.56,13,9,14,13,0.8889686876112561,1.6675167899898216,1.1088696211614302,1.4232042032265197,1.7931348962299707,6.308577281020937,4.895513581077226,42.669889760801816,0.08,29,47,25,4.42292738033765,Humana
1,23,27,5,6,22,2.090909090909091,2.25,1,1,8,1,11,12,17,0.9953784385316868,1.7112568480505783,0.46,12,15,11,11,0.8889686876112561,1.2398346997259868,1.3616778865306827,1.3072431633367745,1.4280248199500896,4.246743852029608,4.552926031795759,20.045348716172587,-0.08,28,48,25,4.42292738033765,Aleatória
0,28,22,6,3,25,2.1538461538461537,1.6923076923076923,1,0,12,3,13,13,18,0.9895875209335165,2.1094074997496333,0.52,15,9,13,12,0.8365012677171205,1.6098807335735654,0.6056929133855239,1.2379597645716216,1.8489948982900564,4.542715417997652,6.200638034614866,22.810351254680512,0.12,31,47,26,4.544876086303667,Aleatória
0,27,23,4,3,37,1.4210526315789473,1.2105263157894737,5,0,33,1,19,19,17,0.9953784385316868,4.63275296125317,0.76,8,4,18,19,0.8889686876112561,0.9902572485382515,0.6137844099837158,0.8305123072662897,2.3875370257711332,6.739080470367496,7.096191996903267,46.910594022312225,0.08,22,50,14,2.9429298849708827,Humana
-1,25,25,5,6,22,2.0833333333333335,2.272727272727273,3,1,13,1,12,11,18,0.9999999997114609,1.9205207627099479,0.46,13,14,11,11,1.0,1.4409680388158819,1.656442468935327,1.5506569130545222,0.9681255113098505,5.702240928053879,2.618310193425895,36.60387638063606,0.0,27,46,22,4.267595923213157,Humana
0,29,21,7,5,27,2.0714285714285716,1.5,3,1,20,2,14,14,16,0.9814538947451146,2.8224811779709005,0.56,15,7,14,13,0.7858751946471527,1.6675167899898218,1.2392393980641052,1.4965947742683545,2.030643057648002,6.535945747365879,6.450096253132767,45.01356700350748,0.16,26,47,23,4.259671401982716,Humana
1,21,29,6,5,28,1.5,1.9333333333333333,3,1,17,1,14,15,18,0.9814538947451146,2.616027522790998,0.58,7,14,14,14,0.7858751946471527,1.2955969390869324,1.0624918300339485,1.2004755300364975,2.216317586197907,5.395563651176945,7.628263568931149,32.340623759161446,-0.16,30,48,23,4.365209510075615,Aleatória
1,22,28,4,6,25,1.6923076923076923,2.1538461538461537,2,2,14,2,13,13,18,0.9895875209335165,2.183941391154992,0.52,9,15,12,13,0.8365012677171205,1.065877420042386,1.5613679330911108,1.356553237580646,1.6185481970827857,5.220436402148389,4.709060080023985,30.585879529314628,-0.12,28,50,28,4.7081320646586,Aleatória
1,18,32,3,6,27,1.2857142857142858,2.2857142857142856,3,3,19,3,14,14,16,0.9426831889669534,2.7141112725899803,0.56,4,18,14,13,0.6438561897747247,0.5890150893739515,1.749635530559413,1.3978846993414948,1.7970883747371584,6.2965732172122335,5.0757521013845635,42.64441423655325,-0.28,26,47,21,4.162057815120258,Humana
1,23,27,3,5,24,1.7692307692307692,2.25,0,1,10,2,13,12,18,0.9953784385316868,1.8894443627691184,0.5,10,15,12,12,0.8889686876112561,0.7994080650317895,1.2332207155790618,1.0583005244258363,1.0124048384175728,4.047252713132071,3.571428571428571,18.39500506084787,-0.08,32,49,25,4.517808423307222,Aleatória
0,26,24,4,4,38,1.3,1.263157894736842,5,0,32,0,20,19,17,0.9988455357066628,4.522344524690705,0.78,6,5,19,19,0.9434164716336324,0.714142842854285,0.713929471907923,0.714276321906878,2.905139971726414,6.592000226994812,10.902221277500272,45.44236514036328,0.04,26,49,21,3.742076371229312,Humana
1,24,26,3,3,33,1.411764705882353,1.5294117647058822,3,0,23,0,17,17,17,0.9988455357066628,3.3671352809175934,0.68,7,9,16,17,0.9434164716336324,0.6910200073218078,0.7759356446042893,0.73705671094951,1.20323035384386,5.938846901917352,2.8857560144427747,38.7961392668708,-0.04,30,50,22,4.278252988336485,Aleatória
1,24,26,7,5,21,2.1818181818181817,2.3636363636363638,0,1,10,2,11,11,18,0.9988455357066628,1.6144348856488455,0.44,13,15,11,10,0.9434164716336324,1.7486712783337586,1.431637795274875,1.6006197146962735,1.346069547165543,4.685125822130923,4.212154006243495,26.01343851711664,-0.04,28,48,23,4.354552444952288,Aleatória
-1,25,25,6,5,36,1.3888888888888888,1.3157894736842106,4,1,31,1,18,19,17,0.9999999997114609,4.362613895361358,0.74,7,6,18,18,1.0,1.1613636089092705,0.9206766149755737,1.0453556543683091,3.51999840733374,6.678021018357881,14.607244988418307,46.30034477005317,0.0,22,49,20,3.909112771133308,Humana
0,31,19,3,2,36,1.631578947368421,1.0555555555555556,2,0,26,1,19,18,15,0.9580420219377606,3.830456891808078,0.74,12,1,18,18,0.6896598793878495,0.6657426652986063,0.2290614236454256,0.5796651510683032,1.4279486672271238,5.930074970696579,4.013213610586011,38.257448822241244,0.24,27,49,14,3.4784778507967204,Humana
0,27,23,7,4,25,2.076923076923077,1.7692307692307692,2,0,14,3,13,13,17,0.9953784385316868,2.1562931155109686,0.52,14,10,13,12,0.8889686876112561,1.7303418275695375,0.890448992522325,1.3846153846153846,2.0504115226337443,5.239032260274346,7.4900548696844975,31.42310780221191,0.08,29,42,27,4.615422010169678,Aleatória
1,21,29,5,6,23,1.75,2.4166666666666665,2,2,14,1,12,12,18,0.9814538947451146,2.0517309765171454,0.48,9,17,11,12,0.7858751946471527,1.2332207155790618,1.70579079087156,1.5252504348102605,1.1980741931779375,5.829313188242388,3.200115838716863,37.89799413795775,-0.16,31,50,24,4.441508966691417,Humana
1,23,27,5,4,26,1.7692307692307692,1.9285714285714286,1,0,13,1,13,14,18,0.9953784385316868,2.210972636646596,0.54,10,13,13,13,0.8889686876112561,1.1200169060431568,1.0326308782000686,1.0785347984119287,1.3593512413412714,4.698627920888068,4.136881452474188,24.471004050066927,-0.08,30,48,28,4.691721466785482,Humana
1,22,28,4,9,13,3.142857142857143,4.0,0,1,3,5,7,7,18,0.9895875209335165,1.2172099243762353,0.28,15,21,7,6,0.8365012677171205,1.3552618543578767,2.2677868380553634,1.9166296949998198,1.1080959088498954,5.375072665472529,5.293703703703703,32.945612471952565,-0.12,21,40,12,3.4361191120739445,Humana
0,26,24,5,3,24,2.1666666666666665,1.8461538461538463,0,0,10,2,12,13,18,0.9988455357066628,1.8894443627691184,0.5,14,11,12,12,0.9434164716336324,1.2133516482134197,0.8634593969478326,1.0583005244258363,1.0124048384175728,4.047252713132071,3.571428571428571,18.39500506084787,0.04,28,47,22,4.303149662852282,Aleatória
0,29,21,4,3,36,1.5263157894736843,1.1666666666666667,3,0,28,1,19,18,16,0.9814538947451146,3.994045568092582,0.74,10,3,18,18,0.7858751946471527,0.8187552203212656,0.5,0.7058143166054375,2.1496286070930855,6.399167033609452,7.130842528014041,43.46060596257673,0.16,27,49,20,3.977139610192507,Humana
1,20,30,3,4,29,1.3333333333333333,2.0,2,0,18,1,15,15,17,0.9709505941661296,2.7129319932501077,0.6,5,15,15,14,0.7369655941662062,0.5962847939999438,1.0327955589886444,0.9067647005823629,0.973662607637745,5.509841796310173,2.574872169466764,34.29773156899808,-0.2,29,46,23,4.25476786960918,Aleatória
0,27,23,12,8,17,3.0,2.5555555555555554,2,1,10,4,9,9,17,0.9953784385316868,1.4527215837867902,0.36,18,14,8,9,0.8889686876112561,3.559026084010437,2.165954298846436,2.954385733401851,1.9495970466332846,5.895352824814155,5.970705152956193,38.85129451689054,0.08,28,50,23,4.132819163643163,Humana
-1,25,25,4,4,21,2.272727272727273,2.272727272727273,0,0,5,0,11,11,18,0.9999999997114609,1.6144348856488453,0.44,14,14,11,10,1.0,1.0523488093445659,0.8624393618641034,0.9620913858416692,0.3518106813501061,3.9436568303251263,2.1895727040816335,18.484160819040696,0.0,29,47,22,4.33814184707917,Aleatória
1,23,27,3,3,36,1.2777777777777777,1.4210526315789473,6,0,28,0,18,19,17,0.9953784385316868,3.994045568092582,0.74,5,8,18,18,0.8889686876112561,0.558326423395605,0.7480352843974681,0.6664231354561054,1.6504962353863442,6.387866643141425,4.228964681440445,43.43502900605748,-0.08,26,49,20,3.978400946934756,Humana
1,24,26,4,4,39,1.2,1.3,6,0,34,0,20,20,17,0.9988455357066628,4.783304297240561,0.8,4,6,19,20,0.9434164716336324,0.6782329983125267,0.714142842854285,0.698212002188447,3.139888293865206,6.689351295434334,12.17948717948718,46.42109638613128,-0.04,25,50,19,3.6085000468761854,Humana
0,26,24,3,3,39,1.3,1.2,5,0,32,0,20,20,17,0.9988455357066628,4.5431266766402185,0.8,6,4,20,19,0.9434164716336324,0.5567764362830021,0.5099019513592785,0.5361902647381804,2.067728053054609,6.503051345326004,6.285444234404538,44.52190373174688,0.04,26,46,17,3.594669435335261,Humana
-1,25,25,4,3,31,1.5625,1.5625,2,0,22,1,16,16,18,0.9999999997114609,3.192240592436604,0.64,9,9,15,16,1.0,0.998044963916957,0.7880950133074057,0.899218410621135,1.2309401641436974,6.087027932763411,3.0222642302037386,40.25795127378574,0.0,29,50,20,4.180639401474028,Humana
0,28,22,2,2,40,1.4,1.0476190476190477,5,0,32,0,20,21,16,0.9895875209335165,4.628995571395592,0.82,8,1,20,20,0.8365012677171205,0.48989794855663565,0.21295885499998,0.4139161645970034,1.3552879972742162,6.217234799462829,2.836805555555556,41.36659017744225,0.12,21,49,11,3.010522361350982,Humana
0,27,23,4,3,36,1.4210526315789473,1.2777777777777777,4,0,30,1,19,18,17,0.9953784385316868,4.218103839404621,0.74,8,5,18,18,0.8889686876112561,0.9355994123490092,0.6502611061510903,0.8126106150471841,2.29887934378733,6.67494170206574,7.078001409664036,46.31107169344111,0.08,27,49,18,3.95441392415736,Humana
-1,25,25,4,3,33,1.4705882352941178,1.4705882352941178,3,0,23,1,17,17,17,0.9999999997114609,3.3611902653673154,0.68,8,8,16,17,1.0,0.8483650059915269,0.6960093862470137,0.7759356446042893,1.6089977442166032,5.988364617120624,4.78913991280222,39.145754114994524,0.0,28,50,25,4.412270315214322,Aleatória
0,27,23,3,2,41,1.2857142857142858,1.0952380952380953,5,0,35,1,21,21,15,0.9953784385316868,4.953221174145164,0.84,6,2,21,20,0.8889686876112561,0.5471012044321932,0.2935435239509036,0.4492371967646002,2.328422309452172,6.578277307611251,7.800908976139373,45.26724533732937,0.08,26,48,16,3.40317736344018,Humana
1,21,29,4,7,19,2.1,2.9,0,2,9,3,10,10,18,0.9814538947451146,1.4422205101855956,0.4,11,19,10,9,0.7858751946471527,1.044030650891055,2.1656407827707715,1.746424919657298,1.0701018051111637,4.6802829056503725,3.33915614082236,26.311390532544383,-0.16,30,48,24,4.3523814564716385,Aleatória
1,21,29,3,5,25,1.6153846153846154,2.230769230769231,2,2,13,2,13,13,18,0.9814538947451146,2.09990475974507,0.52,8,16,13,12,0.7858751946471527,0.737820234355803,1.4225570776082255,1.1741798094210576,1.2897182894432955,4.740998760714756,3.9543738142165075,26.301421255853462,-0.16,27,48,26,4.484987227560983,Aleatória
0,27,23,3,3,38,1.35,1.2105263157894737,3,0,30,0,20,19,17,0.9953784385316868,4.295532563024053,0.78,7,4,19,19,0.8889686876112561,0.5722761571129799,0.5210260492953508,0.5523245956035389,1.8349420809090136,6.35089838041888,5.364595719381685,42.91264047758127,0.08,29,49,15,3.5281173921043854,Humana
0,30,20,5,3,26,2.3076923076923075,1.4285714285714286,1,0,17,2,13,14,18,0.9709505941661296,2.4836263809196426,0.54,17,6,13,13,0.7369655941662062,1.4876215081395165,0.82065180664829,1.26794390878694,1.260579483674022,5.936665943402292,3.37298628988107,38.79852748890853,0.2,29,49,21,4.2326037389862705,Humana
-1,25,25,9,7,27,1.7857142857142858,1.7857142857142858,3,1,19,2,14,14,17,0.9999999997114609,2.7724357521861536,0.56,11,11,14,13,1.0,2.041657989708065,1.5665508713900935,1.819677028979571,3.0222119723759353,6.028668679877822,11.262083898186376,39.438625337198175,0.0,27,40,24,4.33379987011787,Humana
0,27,23,7,5,24,2.25,1.7692307692307692,2,1,16,2,12,13,17,0.9953784385316868,2.29128784747792,0.5,15,10,12,12,0.8889686876112561,1.8314384146529925,1.309952797378954,1.6,1.58203125,6.219833351412171,4.7119140625,41.92081632653062,0.08,31,49,27,4.5990114122965595,Aleatória
1,21,29,2,6,26,1.5,2.230769230769231,1,1,11,4,14,13,18,0.9814538947451146,2.2821919288263204,0.54,7,16,13,13,0.7858751946471527,0.5,1.309952797378954,1.0436298373041015,2.2533965869543247,4.471006771960787,9.587945485346646,21.571866418593828,-0.16,30,49,23,4.3523814564716385,Aleatória
1,23,27,3,5,30,1.5333333333333334,1.6875,3,1,22,2,15,16,17,0.9953784385316868,3.123395588138013,0.62,8,11,15,15,0.8889686876112561,0.8055363982396382,1.3095204274848102,1.0977225501402295,1.6870508448645876,6.42705653503482,4.683906503082857,43.9245766172641,-0.08,27,46,22,4.158475270851117,Humana
1,19,31,4,4,26,1.4615384615384615,2.2142857142857144,2,0,14,0,13,14,18,0.9580420219377606,2.2199999999999998,0.54,6,17,13,13,0.6896598793878495,0.9294650748918901,0.9394961741404219,1.0075163339804032,0.7340223821660876,4.909815586221727,2.17062819576333,28.091591463139096,-0.24,28,48,24,4.255329425021418,Aleatória
0,28,22,4,3,25,2.1538461538461537,1.6923076923076923,0,0,11,1,13,13,17,0.9895875209335165,2.0023985617254123,0.52,15,9,12,13,0.8365012677171205,1.0262818510866412,0.8213137116947163,0.9576845844606717,0.6793680904459196,4.125690605888488,2.374235171696149,19.411893817169204,0.12,28,50,22,4.230432750505622,Aleatória
1,20,30,2,4,30,1.25,2.0,3,0,17,2,16,15,17,0.9709505941661296,2.8134676113294788,0.62,4,15,15,15,0.7369655941662062,0.4330127018922193,0.9660917830792959,0.8299793761463617,1.5006308323293225,4.943747232474265,4.845989905166989,26.687176415412193,-0.2,28,49,20,4.127065630893372,Aleatória
1,21,29,4,5,28,1.4,2.0714285714285716,2,1,19,1,15,14,18,0.9814538947451146,2.77913655655853,0.58,6,15,14,14,0.7858751946471527,0.8,1.4374722712498649,1.200475530036497,1.498780146190553,5.932736326800996,3.7809283403587894,38.772174992245446,-0.16,27,48,22,4.229871195093383,Aleatória
1,23,27,5,6,20,2.090909090909091,2.7,0,2,8,1,11,10,17,0.9953784385316868,1.5243359209832983,0.42,12,17,10,10,0.8889686876112561,1.443137078762504,1.7916472867168918,1.6468206157895795,1.1701690094969073,4.11586515051465,3.0217531123812926,19.2472676346689,-0.08,32,49,28,4.681064401662154,Aleatória
1,22,28,4,3,27,1.5714285714285714,2.0,0,0,14,1,14,14,16,0.9895875209335165,2.3078994778802655,0.56,8,14,14,13,0.8365012677171205,0.9793792286287207,0.7559289460184544,0.9006800152084637,0.7272133408660714,4.633285464433156,2.3029547881808465,24.834848565375886,-0.12,29,46,23,4.221946673862942,Aleatória
1,18,32,6,8,21,1.6363636363636365,2.909090909090909,4,3,15,2,11,11,18,0.9426831889669534,2.127533783515552,0.44,7,21,11,10,0.6438561897747247,1.4937887931959075,2.6783490659374976,2.259964162664737,1.644575360209779,6.4194730617498,4.251940176579633,43.883662506227175,-0.28,26,39,18,3.792067597540827,Humana
0,27,23,6,4,30,1.8,1.4375,1,0,19,2,15,16,18,0.9953784385316868,2.918150098949676,0.62,12,7,15,15,0.8889686876112561,1.2754084313139327,0.7880950133074057,1.0679319585320548,2.5652589508661583,5.462525314388307,10.155572353348605,32.83810950583696,0.08,29,49,27,4.544876086303668,Aleatória
1,21,29,2,8,29,1.4,1.9333333333333333,2,1,18,6,15,15,18,0.9814538947451146,2.8565713714171403,0.6,6,14,15,14,0.7858751946471527,0.4898979485566357,1.8061622912192088,1.3498971154211057,3.5473947099183403,5.224280254675084,16.4857227840571,29.879469434832732,-0.16,27,48,21,4.284006521086277,Aleatória
1,19,31,3,7,22,1.7272727272727273,2.5833333333333335,1,2,9,4,11,12,17,0.9580420219377606,1.7112568480505783,0.46,8,19,11,11,0.6896598793878495,0.8624393618641034,1.70579079087156,1.4341236958670123,1.8160077843368452,3.9593900850099844,6.431106725778546,17.66760551202817,-0.24,29,48,26,4.544876086303667,Aleatória
0,29,21,5,4,25,2.230769230769231,1.6153846153846154,1,0,14,1,13,13,17,0.9814538947451146,2.2021807373601288,0.52,16,8,13,12,0.7858751946471527,1.186711432349347,1.002954216185023,1.1409536133993328,0.9276377198528332,5.113817613740391,2.9010330578512393,29.613205825081863,0.16,28,48,24,4.333799870117869,Humana
1,20,30,5,5,22,1.8181818181818181,2.5,0,1,11,0,11,12,18,0.9709505941661296,1.7229045243425418,0.46,9,18,11,11,0.7369655941662062,1.192261549873091,1.4433756729740645,1.372150768526913,0.7957820483242621,4.877777869382819,2.247254076547154,28.574964871410806,-0.2,31,49,27,4.482816239080333,Aleatória
0,27,23,7,5,24,2.076923076923077,1.9166666666666667,1,1,11,2,13,12,18,0.9953784385316868,2.0024984394500787,0.5,14,11,12,12,0.8889686876112561,1.5913969896597848,1.114924013354971,1.3856406460551018,2.1650635094610964,4.438345805187829,7.8125,21.662956076143807,0.08,27,48,29,4.675310868912363,Aleatória
0,26,24,4,4,35,1.4444444444444444,1.3333333333333333,4,0,27,0,18,18,18,0.9988455357066628,3.8576676891614197,0.72,8,6,17,18,0.9434164716336324,0.7617394000445604,0.816496580927726,0.7915448249319448,2.21622562791254,6.369160959405699,7.158169331942056,43.14723222723248,0.04,27,50,21,4.028542392292513,Humana
1,24,26,4,4,23,2.0,2.1666666666666665,1,0,11,0,12,12,17,0.9988455357066628,1.8787229705307806,0.48,12,14,11,12,0.9434164716336324,1.0,1.2133516482134197,1.114924013354971,0.3766404769062825,4.428617305179148,1.6335632470896662,22.69719400398976,-0.04,23,50,18,3.9796586949993205,Humana
0,38,12,18,5,6,9.5,4.0,0,1,1,13,4,3,15,0.7950402790959832,0.3469870314579494,0.14,34,9,3,3,0.3959286763311392,6.264982043070834,0.816496580927726,5.488392203513871,0.9078393475638483,2.0750055037352473,2.5645504219269832,5.305647840531563,0.52,20,32,14,2.651900983353358,Humana
0,26,24,2,5,39,1.3,1.2,4,1,33,3,20,20,17,0.9988455357066628,4.677606225410602,0.8,6,4,20,19,0.9434164716336324,0.45825756949558394,0.8717797887081346,0.698212002188447,4.021260446529123,6.5469665789083065,21.015779092702168,44.94298299850597,0.04,23,48,14,3.23718884119236,Humana
0,26,24,4,5,34,1.5294117647058822,1.3333333333333333,3,1,26,1,17,18,18,0.9988455357066628,3.7161808352124095,0.7,9,6,17,17,0.9434164716336324,0.8483650059915269,0.9428090415820634,0.9035079029052513,2.5377278222851234,6.363076577298,9.176499999999995,43.04986154813357,0.04,28,49,22,4.14564721724714,Humana
1,21,29,3,4,30,1.4,1.8125,4,0,19,1,15,16,17,0.9814538947451146,2.841760018017004,0.62,6,13,15,15,0.7858751946471527,0.7118052168020875,0.9499177595981665,0.8679757449724973,1.1306489547817746,5.610768249736607,3.0574005677482385,35.37143447342517,-0.16,30,49,25,4.449995043334097,Aleatória
0,35,15,7,3,24,2.6923076923076925,1.25,0,0,13,4,13,12,17,0.8812908989421536,2.0223748416156684,0.5,22,3,12,12,0.5145731728297583,1.6817854699288803,0.5951190357119042,1.469693845669907,1.8900383817771433,5.150206434252992,6.32716049382716,30.333540569460972,0.4,27,48,20,3.968653533549829,Aleatória
0,26,24,2,2,42,1.1818181818181819,1.1428571428571428,4,0,36,0,22,21,16,0.9988455357066628,5.114723843962645,0.86,4,3,21,21,0.9434164716336324,0.385694607919935,0.34992710611188255,0.3691746015438964,1.826828286211264,6.515912705720975,4.337301587301583,44.602618566967024,0.04,21,49,15,3.25520223228828,Humana
1,22,28,4,5,29,1.4666666666666666,1.8666666666666667,3,2,21,1,15,15,18,0.9895875209335165,2.986636904613616,0.6,7,13,15,14,0.8365012677171205,0.8844332774281066,1.4079141387961918,1.1925695879998877,1.7250915060789396,6.388997042224782,4.782714843750001,43.55235375736487,-0.12,25,48,23,4.221037022124542,Humana
-1,25,25,3,3,18,2.5,2.7777777777777777,0,0,0,0,10,9,17,0.9999999997114609,1.927589167846717,0.38,15,16,9,9,1.0,0.5,0.41573970964154905,0.48237638894272,-0.5455447255899819,5.184105664122269,1.2976190476190483,29.195465331895054,0.0,23,48,10,3.1911021779951203,Humana
-1,25,25,7,5,26,1.9230769230769231,1.7857142857142858,2,1,18,2,13,14,18,0.9999999997114609,2.593915958546075,0.54,12,11,13,13,1.0,1.6853001769389726,1.3720980508784677,1.532456360413126,1.9169560141283675,6.1561403859184365,5.869545102192331,41.13785913336033,0.0,30,48,21,4.142566577028091,Humana
1,24,26,6,4,27,1.7142857142857142,1.8571428571428572,2,0,16,2,14,14,18,0.9988455357066628,2.4261904294593206,0.56,10,12,14,13,0.9434164716336324,1.385051387833237,0.9147320339189784,1.175862688082452,1.870787433808173,5.426256599419239,6.618387549189145,33.39239068429861,-0.04,31,46,27,4.604764945046351,Aleatória
0,45,5,27,4,4,15.0,2.5,0,0,1,23,3,2,13,0.46899559330074225,0.3,0.1,42,3,2,2,0.15200309344504997,8.524474568362947,1.5,9.055385138137417,1.0666069347716884,2.666666666666667,2.718441403926234,8.111111111111114,0.8,20,42,12,1.8178009573868175,Humana
1,23,27,3,5,27,1.6428571428571428,1.9285714285714286,3,1,16,2,14,14,18,0.9953784385316868,2.4179330015531866,0.56,9,13,14,13,0.8889686876112561,0.8112726208286106,1.2797480619406367,1.0809104250301114,1.2812378104893436,5.444349467554888,3.8658492400983944,33.711292391180265,-0.08,29,48,24,4.441508966691418,Aleatória
0,26,24,4,6,24,2.1666666666666665,1.8461538461538463,2,1,15,2,12,13,18,0.9988455357066628,2.202271554554524,0.5,14,11,12,12,0.9434164716336324,1.1426091000668408,1.6098807335735654,1.4142135623730951,1.1879393923933996,5.814053078449823,3.38,37.75289616324796,0.04,29,49,21,4.305320651332932,Humana
1,22,28,4,5,30,1.375,1.8666666666666667,3,1,18,1,16,15,16,0.9895875209335165,2.8558011135231394,0.62,6,13,15,15,0.8365012677171205,0.7806247497997998,1.024152766382481,0.9393690179716796,2.006711493488603,5.207738853991501,7.065653924884304,29.765507725973112,-0.12,30,49,26,4.501397825434102,Aleatória
-1,25,25,6,6,21,2.272727272727273,2.272727272727273,1,1,8,0,11,11,17,0.9999999997114609,1.6144348856488455,0.44,14,14,10,11,1.0,1.4826824027545535,1.4826824027545535,1.4826824027545535,1.3664248137093524,4.143283097349761,4.00115891231839,19.291071022794693,0.0,33,50,27,4.604764945046352,Aleatória
0,26,24,5,4,31,1.625,1.5,2,0,21,1,16,16,18,0.9988455357066628,3.0838936427834214,0.64,10,8,15,16,0.9434164716336324,1.0532687216470449,0.8660254037844386,0.9662265521087692,2.0054939517518195,5.924427020735177,6.6625759352952505,38.360720753501944,0.04,27,50,24,4.333799870117869,Humana
1,23,27,4,7,23,1.9166666666666667,2.25,1,1,11,3,12,12,18,0.9953784385316868,1.857309882599024,0.48,11,15,11,12,0.8889686876112561,1.0374916331657276,1.6393596310755,1.3819269959814167,1.8397674043690442,4.432977935597154,7.051914049586774,22.85145523043083,-0.08,30,50,26,4.561286684176786,Aleatória
0,26,24,2,3,36,1.4444444444444444,1.263157894736842,2,0,26,1,18,19,17,0.9988455357066628,3.830456891808078,0.74,8,5,18,18,0.9434164716336324,0.4969039949999533,0.6359497880839249,0.5796651510683032,1.427948667227124,5.930074970696579,4.01321361058601,38.257448822241244,0.04,23,49,18,3.77307826349875,Humana
0,28,22,4,4,30,1.75,1.4666666666666666,0,0,19,0,16,15,17,0.9895875209335165,2.841760018017004,0.62,12,7,15,15,0.8365012677171205,0.9013878188659973,0.8844332774281066,0.9043771463791087,1.3624944200504343,5.642142279006842,3.8038867198881228,35.52070002471883,0.12,28,47,25,4.368792054344757,Aleatória
-1,25,25,5,5,23,2.0833333333333335,2.0833333333333335,1,1,12,0,12,12,18,0.9999999997114609,1.8680471086136987,0.48,13,13,12,11,1.0,1.4409680388158819,1.25554326444328,1.3514395616855712,0.9626874768085625,5.02925383296543,2.5377408954878633,29.69924639896771,0.0,31,48,26,4.528465488430548,Aleatória
1,22,28,3,5,34,1.2222222222222223,1.6470588235294117,5,1,27,2,18,17,17,0.9895875209335165,3.8223029707232787,0.7,4,11,17,17,0.8365012677171205,0.5328701692569688,1.1345471483521123,0.9035079029052512,2.3053004142627485,6.526699421356533,8.074,44.84309922460354,-0.12,26,49,21,4.030713380773162,Humana
0,31,19,8,5,21,2.8181818181818183,1.7272727272727273,1,1,12,3,11,11,17,0.9580420219377606,1.7794381135628183,0.44,20,8,10,11,0.6896598793878495,2.0368505911280073,1.28564869306645,1.7883923248096363,1.5892163673162651,5.603985522720619,5.289165314584459,35.80978929594494,0.24,27,50,24,4.398030705821853,Humana
0,27,23,2,1,45,1.173913043478261,1.0,6,0,42,1,23,23,16,0.9953784385316868,5.895218401382597,0.92,4,0,23,22,0.8889686876112561,0.3790346907426672,0.0,0.2817713347133852,2.931763649279747,6.766599740752967,9.595238095238093,47.15970783378104,0.08,16,48,6,2.271549246555057,Humana
0,29,21,4,2,31,1.8125,1.3125,1,0,19,2,16,16,17,0.9814538947451146,2.985029313088902,0.64,13,5,16,15,0.7858751946471527,1.0135796712641785,0.46351240544347894,0.8267972847076845,1.6250312542408145,5.263212020424176,5.158563265306123,30.560021952835697,0.16,29,47,21,4.32173124920605,Humana
-1,25,25,6,6,22,2.0833333333333335,2.272727272727273,1,1,12,0,12,11,17,0.9999999997114609,1.824390309116994,0.46,13,14,11,11,1.0,1.4409680388158819,1.6564424689353272,1.5506569130545225,1.2479825580218233,5.271391117761123,3.5756200308532113,32.39971762462738,0.0,27,48,24,4.40868777094518,Humana
0,26,24,3,4,30,1.625,1.6,0,0,17,1,16,15,17,0.9988455357066628,2.756011611006021,0.62,10,9,15,15,0.9434164716336324,0.5994789404140899,0.9521904571390465,0.7901579815429605,1.1949427461877284,4.989779428608139,3.8231000000000033,27.652303196142075,0.04,28,48,23,4.259671401982716,Humana
1,11,39,1,29,21,1.0,3.5454545454545454,3,5,21,28,11,11,15,0.7601675026734266,2.9404761519182565,0.44,0,28,11,10,0.3584539709124763,0.0,8.049434044064967,5.832369066307432,4.364357804719848,6.833618851538746,20.04761904761905,47.803137572245454,-0.56,14,20,6,1.759321634962888,Humana
0,27,23,4,4,27,1.9285714285714286,1.6428571428571428,1,0,14,0,14,14,17,0.9953784385316868,2.342306555513176,0.56,13,9,13,14,0.8889686876112561,1.0326308782000684,0.8949974347244049,0.9767710236555247,1.1285840727437957,4.728661787242224,3.210300551917411,25.08057056443329,0.08,33,50,30,4.778677988524612,Aleatória
-1,25,25,4,4,28,1.6666666666666667,1.7857142857142858,0,0,15,0,15,14,17,0.9999999997114609,2.458373446000424,0.58,10,11,14,14,1.0,0.8692269873603531,0.9394961741404219,0.9057879680388757,1.1275148173291987,4.8507073279494985,3.369766855702583,26.45162564172142,0.0,31,49,27,4.59901141229656,Aleatória
0,30,20,7,4,21,2.727272727272727,1.8181818181818181,1,0,9,3,11,11,17,0.9709505941661296,1.6019987515600629,0.44,19,9,10,11,0.7369655941662062,1.8136306675690914,0.9359663764533637,1.5130288160993852,1.421847577641389,4.107431259990427,4.850200054738102,19.716354375905617,0.2,29,50,29,4.675310868912363,Aleatória
0,27,23,3,2,40,1.2857142857142858,1.15,5,0,33,1,21,20,16,0.9953784385316868,4.7018719676316145,0.82,6,3,20,20,0.8889686876112561,0.5471012044321932,0.3570714214271425,0.46915570882125235,2.036786905463753,6.452165626553264,6.405741417092768,43.9430187541438,0.08,22,49,12,3.1319691632669078,Humana
0,26,24,7,7,29,1.7333333333333334,1.6,4,1,25,0,15,15,17,0.9988455357066628,3.509985754956849,0.6,11,9,14,15,0.9434164716336324,1.6519348924485153,1.624807680927192,1.6397831834998455,2.4477468393818134,6.7166439755578144,7.770985588416094,46.707286220273204,0.04,23,50,17,3.648804761328154,Humana
1,24,26,5,4,27,1.7142857142857142,1.8571428571428572,1,0,14,1,14,14,18,0.9988455357066628,2.3337523433303717,0.56,10,12,13,14,0.9434164716336324,1.097306535409801,0.9147320339189784,1.0126747770541304,1.4696454921471684,4.776696359334328,4.844657310462611,25.447407038929782,-0.04,32,50,27,4.631832608042798,Aleatória
1,21,29,4,4,28,1.4,2.0714285714285716,3,0,19,0,15,14,18,0.9814538947451146,2.7501999927278025,0.58,6,15,14,14,0.7858751946471527,0.879393730551528,1.222660197758835,1.110965771971518,1.1625997520180418,6.066137239435616,2.7276832949090632,40.32043162343365,-0.16,29,49,25,4.387373640698525,Aleatória
0,27,23,10,7,22,2.4545454545454546,1.9166666666666667,3,2,19,3,11,12,17,0.9953784385316868,2.662404927880054,0.46,16,11,11,11,0.8889686876112561,3.1148803089112382,2.0598678490513795,2.63178190442114,1.9433639805004668,6.74964933256734,5.162543084132644,47.03066691783708,0.08,20,49,18,3.5641730357936017,Humana
0,29,21,9,4,30,1.8125,1.4,2,0,23,5,16,15,18,0.9814538947451146,3.261226763044852,0.62,13,6,15,15,0.7858751946471527,1.9435389756832766,0.879393730551528,1.5382734216214662,3.6953663152173584,6.481152835557264,17.40427060054813,44.3802839464513,0.16,27,49,23,4.158977174901208,Humana
1,19,31,8,4,23,1.5833333333333333,2.5833333333333335,1,0,13,4,12,12,17,0.9580420219377606,2.0614557962760203,0.48,7,19,11,12,0.6896598793878495,1.9346977943739834,0.8620067027323834,1.5789412767913678,2.1490488358224615,5.110517257133627,8.459128963927965,29.221494694894027,-0.24,19,50,14,3.2663381751485936,Humana
1,24,26,2,3,42,1.0909090909090908,1.2380952380952381,5,0,37,1,22,21,15,0.9988455357066628,5.211564064654681,0.86,2,5,21,21,0.9434164716336324,0.28747978728803447,0.5259695722470125,0.4275529374616334,2.6707201048183755,6.67525512976874,9.656402086761666,46.258504806684996,-0.04,22,49,14,3.185542933847563,Humana
0,28,22,5,2,38,1.4,1.1578947368421053,4,0,33,3,20,19,17,0.9895875209335165,4.640215512236475,0.78,8,3,19,19,0.8365012677171205,1.0677078252031311,0.36464227527765836,0.8148845426702925,3.421800926895705,6.697958518818706,14.358574649544162,46.497512070013194,0.12,24,49,16,3.5246850668814873,Humana
0,32,18,7,2,27,2.2857142857142856,1.2857142857142858,1,0,17,5,14,14,18,0.9426831889669534,2.554681976293723,0.56,18,4,13,14,0.6438561897747247,1.7899948694488097,0.45175395145262565,1.3978846993414948,2.3462209471512745,5.6414999704223,8.218400834418393,35.109422143843204,0.28,28,50,21,4.294663586209604,Aleatória
1,23,27,4,6,36,1.2105263157894737,1.5,5,1,32,2,19,18,16,0.9953784385316868,4.484685050257153,0.74,4,9,18,18,0.8889686876112561,0.6942582083301536,1.3017082793177757,1.045355654368309,3.2360840834287217,6.770069625611477,12.816180045182879,47.21355072497972,-0.08,22,46,16,3.3533840144085865,Humana
0,32,18,5,5,28,2.1333333333333333,1.2857142857142858,3,1,22,0,15,14,17,0.9426831889669534,3.124675983202099,0.58,17,4,14,14,0.6438561897747247,1.5860503004493758,1.0301575072754254,1.4116889303764635,1.6723183837050914,6.465047372118568,4.098112621823756,44.19663718426001,0.28,22,45,19,3.906593686326495,Humana
0,33,17,7,3,24,2.5384615384615383,1.4166666666666667,2,0,13,4,13,12,17,0.924818704684491,2.0518284528683193,0.5,20,5,12,12,0.5994620704162712,1.8652854850741756,0.6400954789890506,1.5231546211727816,2.0375136133405225,4.994097271891903,6.673602853745542,28.754210368932696,0.32,29,48,23,4.341724391348311,Aleatória
0,30,20,5,3,23,2.5,1.6666666666666667,1,0,8,2,12,12,17,0.9709505941661296,1.7915356541246954,0.48,18,8,11,12,0.7369655941662062,1.118033988749895,0.7453559924999299,1.0374916331657276,0.9524626622727697,3.9351547782481964,3.6111134235171707,17.254229832933888,0.2,28,50,21,4.229871195093384,Aleatória
-1,25,25,3,4,28,1.6666666666666667,1.7857142857142858,1,0,17,1,15,14,17,0.9999999997114609,2.554133904085689,0.58,10,11,14,14,1.0,0.7888106377466154,1.1450871101343858,0.9789703149364407,1.0147513848861527,5.51392439612634,2.6883454734651404,34.52546008674873,0.0,30,48,23,4.441508966691418,Aleatória
0,28,22,6,5,21,2.5454545454545454,2.0,0,1,7,1,11,11,18,0.9895875209335165,1.7338973441354597,0.44,17,11,10,11,0.8365012677171205,1.4373989364401727,1.2792042981336627,1.3876670474976134,1.2399515274569293,4.486344663159083,3.5972849011770354,22.679826977594132,0.12,29,50,23,4.381620107948734,Aleatória
0,26,24,4,7,25,2.0,1.8461538461538463,0,1,12,3,13,13,18,0.9988455357066628,2.1094074997496333,0.52,13,11,13,12,0.9434164716336324,0.9607689228305228,1.5613679330911103,1.298611001241087,2.355677958077737,4.542715417997652,9.408938134810711,22.810351254680516,0.04,30,46,25,4.484987227560983,Aleatória
0,30,20,6,4,22,2.5,1.8181818181818181,1,0,11,2,12,11,17,0.9709505941661296,1.7912007146045918,0.46,18,9,11,11,0.7369655941662062,1.8027756377319946,1.1134044285378082,1.5506569130545222,1.317946819699817,4.7216981155795335,3.6344710454491547,25.904186664599596,0.2,27,49,22,4.32173124920605,Aleatória
-1,25,25,4,4,27,1.7857142857142858,1.7857142857142858,1,0,16,0,14,14,17,0.9999999997114609,2.4344198487524706,0.56,11,11,13,14,1.0,1.0126747770541304,1.0126747770541304,1.0126747770541304,0.8506257576324586,5.375072665472528,2.2831365560258408,32.94561247195255,0.0,31,50,25,4.490740760310775,Aleatória
0,29,21,4,4,30,1.8125,1.4,0,0,19,0,16,15,18,0.9814538947451146,2.841760018017004,0.62,13,6,15,15,0.7858751946471527,0.8816709987291178,0.879393730551528,0.9043771463791087,1.3624944200504339,5.642142279006842,3.8038867198881223,35.52070002471883,0.16,31,49,24,4.249014336859389,Humana
1,18,32,2,5,33,1.0588235294117647,1.8823529411764706,4,1,25,3,17,17,17,0.9426831889669534,3.5857495729623956,0.68,1,15,17,16,0.6438561897747247,0.23529411764705885,1.2310852668503736,0.9772498662256559,2.3514497608166,6.300000469183003,7.698645242596093,42.42029756092606,-0.28,26,47,16,3.699357543051905,Humana
1,24,26,6,7,29,1.6,1.7333333333333334,4,2,24,1,15,15,17,0.9988455357066628,3.3645207682521443,0.6,9,11,15,14,0.9434164716336324,1.4047538337136984,1.7307673314329557,1.5776212754932306,2.341152745799307,6.724924578678759,7.10060586734694,46.796626253293184,-0.04,23,43,21,3.7898966090601762,Humana
0,27,23,5,3,26,1.9285714285714286,1.7692307692307692,1,0,14,2,14,13,17,0.9953784385316868,2.2109726366465954,0.54,13,10,13,13,0.8889686876112561,1.2226601977588347,0.8904489925223251,1.0785347984119287,1.1822241462022485,4.96509427796017,3.711101593093627,28.549399853732982,0.08,32,49,27,4.621175542919469,Aleatória
1,19,31,3,8,22,1.5833333333333333,2.8181818181818183,2,3,14,5,12,11,18,0.9580420219377606,2.0416659863944444,0.46,7,20,11,11,0.6896598793878495,0.7592027982620249,2.724240738867581,2.056848030002586,1.9841661985260235,5.90921652586718,5.820532263822305,38.79178456292459,-0.24,25,49,20,4.011629890369303,Humana
1,20,30,2,7,31,1.25,1.875,2,1,20,5,16,16,17,0.9709505941661296,3.1032885782666106,0.64,4,14,15,16,0.7369655941662062,0.4330127018922193,1.4523687548277813,1.1162856937182344,3.617361959498482,5.396773471200858,17.726840341584694,31.951277536403023,-0.2,28,50,21,4.154133293889817,Aleatória
0,27,23,4,2,41,1.2857142857142858,1.0952380952380953,6,0,37,2,21,21,15,0.9953784385316868,5.185981102935104,0.84,6,2,20,21,0.8889686876112561,0.764875162105191,0.2935435239509036,0.5870870479018072,3.4637475149992754,6.777423917210687,14.904172437673132,47.27497528769842,0.08,22,50,13,2.8135355355114102,Humana
0,28,22,4,5,26,2.0,1.6923076923076923,1,2,16,1,14,13,18,0.9895875209335165,2.359745749016194,0.54,14,9,13,13,0.8365012677171205,1.0,1.4349813927828945,1.238389147948184,1.3356690440702212,5.7444201468942495,3.671047199669739,37.037735177073735,0.12,30,49,23,4.365209510075616,Aleatória
1,24,26,4,6,20,2.1818181818181817,2.6,1,2,8,2,11,10,17,0.9988455357066628,1.4709180806557518,0.42,13,16,10,10,0.9434164716336324,1.1134044285378082,1.9078784028338915,1.5576597365520122,1.0912379906849667,3.9653925573743316,3.1807022447375317,18.494905832158487,-0.04,30,47,26,4.561286684176786,Aleatória
1,22,28,4,7,34,1.2222222222222223,1.6470588235294117,4,1,29,3,18,17,17,0.9895875209335165,4.075536774462967,0.7,4,11,17,17,0.8365012677171205,0.7114582486036499,1.5316725372107691,1.2020390838835788,3.376022822015261,6.695889469040521,14.400794790768941,46.50127241773144,-0.12,22,49,19,3.9091127711333082,Humana
-1,25,25,2,3,46,1.0416666666666667,1.0869565217391304,7,0,45,1,24,23,14,0.9999999997114609,6.29733276872042,0.94,1,2,23,23,1.0,0.19982631347136331,0.4078622399846461,0.3198573697526151,5.244994546609076,6.8469205470735846,30.128945101417504,47.927593455201794,0.0,17,49,10,2.0144044449514418,Humana
0,27,23,4,6,31,1.6875,1.4375,2,1,23,2,16,16,18,0.9953784385316868,3.2726747470532414,0.64,11,7,15,16,0.8889686876112561,0.9164298936634487,1.27322179921646,1.1162856937182344,2.4042030141295587,6.401235094031242,8.821267479682787,43.610817146561956,0.08,26,50,22,4.082677718285405,Humana
1,21,29,4,9,22,1.75,2.6363636363636362,1,1,11,5,12,11,18,0.9814538947451146,1.7912007146045918,0.46,9,18,11,11,0.7858751946471527,0.924211375534118,2.307014098263549,1.7852578406650268,2.4424253276490213,4.7216981155795335,9.529200069232493,25.904186664599603,-0.16,31,48,26,4.50988390207678,Aleatória
0,33,17,6,3,24,2.5384615384615383,1.4166666666666667,1,0,14,3,13,12,17,0.924818704684491,2.1,0.5,20,5,12,12,0.5994620704162712,1.78089798504465,0.6400954789890506,1.469693845669907,1.5876322406928005,5.494007126660188,4.681069958847736,34.47444737532201,0.32,27,47,25,4.4472624994412095,Aleatória
-1,25,25,4,5,30,1.5625,1.6666666666666667,4,1,21,1,16,15,17,0.9999999997114609,3.0192051934242565,0.62,9,10,15,15,1.0,1.0588171466310885,1.0749676997731397,1.067931958532055,1.770695084501696,6.2083962858283215,5.134630241355422,41.61373759717698,0.0,30,46,26,4.441508966691418,Humana
0,27,23,5,3,33,1.588235294117647,1.3529411764705883,5,0,25,2,17,17,17,0.9953784385316868,3.563369192211214,0.68,10,6,17,16,0.8889686876112561,1.0878377652298192,0.6809315825170721,0.9150793638884732,2.1595710484773223,6.384231824680257,7.491325729116864,43.42649322096939,0.08,27,48,22,4.2197756853822925,Humana
0,26,24,5,4,29,1.7333333333333334,1.6,3,0,19,1,15,15,17,0.9988455357066628,2.8354893757515653,0.6,11,9,14,15,0.9434164716336324,1.18133634311129,1.0198039027185568,1.1055415967851332,1.7213556763166868,5.698560923347149,4.824793388429751,35.9953218979728,0.04,34,50,25,4.517808423307221,Aleatória
0,27,23,7,4,22,2.4545454545454546,1.9166666666666667,0,0,10,3,11,12,18,0.9953784385316868,1.7229045243425418,0.46,16,11,11,11,0.8889686876112561,1.827250112931071,1.114924013354971,1.5223601217401386,1.6274878007105569,4.50235770603276,5.248885618558212,22.98366178092843,0.08,31,49,26,4.561286684176786,Aleatória
1,23,27,5,6,25,1.7692307692307692,2.076923076923077,3,3,19,1,13,13,18,0.9953784385316868,2.6999259249097927,0.52,10,14,13,12,0.8889686876112561,1.4225570776082255,1.9791815892720932,1.7303418275695372,1.5439912926705288,6.428797973370596,3.5834726366604697,43.91567275947896,-0.08,25,48,18,4.023698511281123,Humana
0,27,23,7,8,12,3.857142857142857,3.8333333333333335,0,2,3,1,7,6,17,0.9953784385316868,0.7696752561957543,0.26,20,17,6,6,0.8889686876112561,2.356060357495806,2.6718699236468995,2.5067954979692804,0.408970908403417,2.939654510225666,1.5933001372530242,10.20462067119823,0.08,27,49,18,3.829384577972292,Humana
0,26,24,6,10,30,1.625,1.6,4,2,25,4,16,15,17,0.9988455357066628,3.5150533424117483,0.62,10,9,15,15,0.9434164716336324,1.2686114456365274,2.244994432064365,1.8081788977085829,3.664042226808811,6.67456360733329,16.071911892873747,46.2897473908074,0.04,21,48,20,3.670118891574808,Humana
0,27,23,7,6,27,1.9285714285714286,1.6428571428571428,2,2,20,1,14,14,18,0.9953784385316868,2.829558269412383,0.56,13,9,13,14,0.8889686876112561,1.5795245991068558,1.585971665083894,1.589185390091928,2.168880527245387,6.494654164481261,6.57022344658708,44.57330226945538,0.08,25,50,20,4.0848487067660555,Humana
0,27,23,6,6,30,1.6875,1.5333333333333334,4,1,23,0,16,15,18,0.9953784385316868,3.261226763044852,0.62,11,8,15,15,0.8889686876112561,1.3564084008881692,1.309792180292567,1.336278398529547,2.4345335006447315,6.481152835557262,7.894998940453483,44.3802839464513,0.08,29,46,25,4.256938858089829,Humana
0,26,24,5,6,31,1.625,1.5,5,1,27,1,16,16,18,0.9988455357066628,3.793468070249174,0.64,10,8,15,16,0.9434164716336324,1.3169567191065923,1.3693063937629153,1.3448396744593758,2.141013318621143,6.710963357374197,6.075939151649726,46.63379522305516,0.04,27,50,16,3.834636206671992,Humana
-1,25,25,2,3,41,1.1904761904761905,1.1904761904761905,5,0,35,1,21,21,16,0.9999999997114609,4.953221174145164,0.84,4,4,20,21,1.0,0.39267672624930106,0.49943278484292924,0.44923719676460017,2.328422309452173,6.578277307611251,7.800908976139378,45.26724533732937,0.0,24,50,16,3.3041522207892293,Humana
1,18,32,3,6,21,1.6363636363636365,2.909090909090909,1,3,10,3,11,11,17,0.9426831889669534,1.6019987515600629,0.44,7,21,10,11,0.6438561897747247,0.8813963377120598,1.729663417312768,1.5130288160993852,1.0281552277681443,4.6911783408495165,2.948363721669774,26.36276826636649,-0.28,29,50,21,4.213460597220265,Humana
1,21,29,3,7,27,1.5,2.0714285714285716,2,1,16,4,14,14,18,0.9814538947451146,2.45894286228859,0.56,7,15,14,13,0.7858751946471527,0.7319250547113999,1.5795245991068558,1.2637004294967238,2.5310899680262655,5.274935400698119,10.590298972123835,31.784541050488535,-0.16,32,46,28,4.631832608042798,Aleatória
0,32,18,14,11,16,3.5555555555555554,2.25,1,2,11,3,9,8,17,0.9426831889669534,1.5825296205758677,0.34,23,10,8,8,0.6438561897747247,4.003085229922627,3.307189138830738,3.74904832214781,2.0218413403064974,6.15302572878605,5.767081797864269,41.2282435811869,0.28,21,36,18,3.5901772393277183,Humana
0,26,24,5,4,27,1.8571428571428572,1.7142857142857142,3,0,17,1,14,14,17,0.9988455357066628,2.4912647390432037,0.56,12,10,13,14,0.9434164716336324,1.1866605518454392,1.0973065354098013,1.1450871101343856,1.2815461124488448,5.8465196104286274,3.531453920574118,38.07777277333857,0.04,31,50,26,4.5719437493001145,Aleatória
-1,25,25,6,7,21,2.272727272727273,2.272727272727273,1,2,13,1,11,11,18,0.9999999997114609,1.867190402717409,0.44,14,14,10,11,1.0,1.8136306675690914,1.9112541856026033,1.8630819574471997,1.2446211287497182,6.112773874395679,3.194047619047618,40.98050690800689,0.0,30,50,25,4.517808423307221,Aleatória
-1,25,25,4,5,27,1.7857142857142858,1.7857142857142858,3,1,17,1,14,14,17,0.9999999997114609,2.554681976293723,0.56,11,11,14,13,1.0,1.2058530725810097,1.2058530725810095,1.2058530725810095,1.3942022007045585,5.562329468322561,3.5369529085872586,34.77878322594316,0.0,28,45,26,4.517808423307221,Aleatória
1,23,27,4,5,35,1.2777777777777777,1.5,5,1,31,1,18,18,16,0.9953784385316868,4.345296307503092,0.72,5,9,17,18,0.8889686876112561,0.8031573497111645,1.1666666666666667,1.0076865081787252,2.4224470479778435,6.7645162864890205,7.467641651499896,47.161222672965344,-0.08,26,50,18,3.7285961945290005,Humana
1,22,28,7,9,18,2.4444444444444446,2.8,1,2,11,2,9,10,18,0.9895875209335165,1.5986244086714052,0.38,13,18,9,9,0.8365012677171205,2.454524670486058,2.5612496949731396,2.5175285774950313,1.3690538990754193,5.916551741293754,3.380700156486869,39.02011346538564,-0.12,27,47,25,4.307993543863672,Humana
1,22,28,4,6,20,2.0,2.8,0,3,9,2,11,10,17,0.9895875209335165,1.4844527611210805,0.42,11,18,10,10,0.8365012677171205,0.9534625892455924,2.0396078054371136,1.6176464525202885,1.0578530002690842,4.429457478902229,2.9931832312595175,23.706327614994343,-0.12,30,49,22,4.249014336859389,Aleatória
1,24,26,6,3,25,1.8461538461538463,2.0,1,0,13,3,13,13,18,0.9988455357066628,2.1469979040511427,0.52,11,13,12,13,0.9434164716336324,1.4058205294228512,0.8770580193070292,1.1741798094210576,1.5748227903143444,4.646795817924876,5.971578036066237,24.874911101122038,-0.04,29,50,24,4.4393379782107685,Aleatória
1,20,30,3,4,31,1.25,1.875,3,0,21,1,16,16,17,0.9709505941661296,3.064375956047169,0.64,4,14,15,16,0.7369655941662062,0.6614378277661477,0.9921567416492215,0.899218410621135,1.4888130626877125,5.975465150318411,4.097668557025835,39.17058239327142,-0.2,25,50,18,3.796911478552217,Humana
0,28,22,7,4,33,1.6470588235294117,1.2941176470588236,4,0,28,3,17,17,18,0.9895875209335165,3.9316154440636737,0.68,11,5,16,17,0.8365012677171205,1.6428517698551697,0.7487012977269327,1.288758958835685,3.115457317975999,6.71004870656294,12.074661458333331,46.63357980449781,0.12,28,50,19,3.783581520898148,Humana
0,27,23,4,3,29,1.8,1.5333333333333334,1,0,18,1,15,15,18,0.9953784385316868,2.7129319932501073,0.6,12,8,15,14,0.8889686876112561,1.1661903789690602,0.7180219742846006,0.9775252199076785,1.3481283454648891,5.545900970369796,3.610059491617091,34.47849716446123,0.08,29,48,24,4.468576629687864,Humana
0,26,24,4,5,35,1.4444444444444444,1.3333333333333333,5,1,29,1,18,18,16,0.9988455357066628,4.074506105038991,0.72,8,6,18,17,0.9434164716336324,0.8958064164776166,0.9428090415820634,0.921284663987611,2.5660260030901743,6.686355612049618,8.910347107438016,46.41689812695686,0.04,26,47,20,3.731419306105985,Humana
0,27,23,3,2,43,1.2272727272727273,1.0454545454545454,6,0,40,1,22,22,15,0.9953784385316868,5.60228524800371,0.88,5,1,22,21,0.8889686876112561,0.597861201725723,0.20829889522526548,0.4568125282327677,3.369333851998182,6.8064219226363,13.179198117831588,47.55216768812752,0.08,23,46,12,2.4912387321166696,Humana
0,28,22,5,3,29,1.8666666666666667,1.4666666666666666,1,0,17,2,15,15,18,0.9895875209335165,2.6758176320519307,0.6,13,7,14,15,0.8365012677171205,1.2036980056845192,0.618241233033047,0.9775252199076785,1.7763573493184426,5.216178312098981,5.946457544618712,30.16756655535094,0.12,31,50,26,4.588354347173233,Humana
0,26,24,3,2,41,1.2380952380952381,1.1428571428571428,5,0,35,1,21,21,17,0.9988455357066628,4.953221174145164,0.84,5,3,20,21,0.9434164716336324,0.5259695722470125,0.34992710611188255,0.4492371967646002,2.328422309452172,6.578277307611251,7.800908976139374,45.26724533732937,0.04,21,50,15,3.2770845577927834,Humana
0,27,23,4,3,26,2.076923076923077,1.6428571428571428,1,0,12,1,13,14,18,0.9953784385316868,2.1467184258770406,0.54,14,9,13,13,0.8889686876112561,0.9970370305242862,0.7178482586514923,0.890430761494171,0.6086616278522102,4.196623023743622,2.24137043378312,20.00040198611292,0.08,29,49,25,4.501397825434102,Aleatória
0,28,22,6,3,29,1.8666666666666667,1.4666666666666666,1,0,18,3,15,15,18,0.9895875209335165,2.7422618401604177,0.6,13,7,14,15,0.8365012677171205,1.4079141387961915,0.6182412330330469,1.1055415967851332,2.313414316578478,5.495541142444607,8.752066115702483,33.48234495246715,0.12,31,50,25,4.528465488430549,Aleatória
0,26,24,2,2,46,1.0833333333333333,1.0434782608695652,6,0,44,0,24,23,15,0.9988455357066628,6.165744075129942,0.94,2,1,23,23,0.9434164716336324,0.2763853991962833,0.20393111999232305,0.24444947432076722,3.568591947091804,6.809672786168891,13.734848484848479,47.57635099245687,0.04,23,49,10,2.3266347815795863,Humana
0,26,24,5,3,25,2.0,1.8461538461538463,0,0,11,2,13,13,18,0.9988455357066628,2.041959842896035,0.52,13,11,13,12,0.9434164716336324,1.0377490433255416,0.9483713850721502,0.9970370305242863,1.0856342836618602,4.058513488621898,4.113520408163261,18.519278670333353,0.04,26,48,22,4.170543891762937,Aleatória
0,26,24,15,8,21,2.3636363636363638,2.1818181818181817,2,2,18,7,11,11,17,0.9988455357066628,2.5231726060656254,0.44,15,13,10,11,0.9434164716336324,4.006193552096492,2.516064091472372,3.34639314896472,2.8116209238271033,6.73769678375693,10.09879658501382,46.9191028092257,0.04,22,50,18,3.5078058197946778,Humana
-1,25,25,3,4,43,1.1363636363636365,1.1363636363636365,6,0,41,1,22,22,15,0.9999999997114609,5.736340296739725,0.88,3,3,21,22,1.0,0.4568125282327677,0.6248966856757963,0.5473452081269224,4.226728560831731,6.839072590003074,20.22739595719382,47.85625270752323,0.0,22,50,14,2.5781952538557995,Humana
0,28,22,7,5,19,2.8,2.2,0,1,6,2,10,10,17,0.9895875209335165,1.3564659966250534,0.4,18,12,10,9,0.8365012677171205,1.7776388834631178,1.32664991614216,1.5968719422671311,1.289285305175308,3.865543459191434,4.031141868512111,17.335538752362954,0.12,30,46,26,4.577697282049905,Aleatória
0,26,24,6,4,30,1.7333333333333334,1.5,2,0,20,2,15,16,18,0.9988455357066628,2.9522195040342107,0.62,11,8,15,15,0.9434164716336324,1.2892719737209146,0.8660254037844386,1.0977225501402295,2.4186645009633536,5.85342104717921,9.181593241876739,37.579685226185845,0.04,30,48,27,4.507712913596131,Aleatória
0,40,10,5,1,20,3.6363636363636362,1.0,0,0,11,4,11,10,15,0.7219280945988233,1.6862977198585074,0.42,29,0,10,10,0.3219280948873623,1.2264306875665492,0.0,1.5879363810031493,0.503323890549708,5.205873381108247,1.564981108638269,31.5260320669163,0.6,20,49,9,2.8036379030802396,Humana
0,27,23,6,4,25,2.076923076923077,1.7692307692307692,3,0,17,2,13,13,17,0.9953784385316868,2.459593462342913,0.52,14,10,13,12,0.8889686876112561,1.5423028965971863,1.2498520622516862,1.412119980821986,1.2836018806205576,6.084994222235752,3.550537558664777,40.41199937520815,0.08,25,45,16,3.876853130799308,Humana
0,28,22,5,4,27,2.0,1.5714285714285714,3,0,19,1,14,14,17,0.9895875209335165,2.7288092641296866,0.56,14,8,13,14,0.8365012677171205,1.4142135623730951,0.9793792286287207,1.2351154618421845,1.2080786170773032,6.218289501649129,2.989552689567231,41.769227352750136,0.12,25,50,20,3.9978921850269247,Humana
1,21,29,4,4,26,1.5,2.230769230769231,1,0,17,0,14,13,18,0.9814538947451146,2.4996799795173787,0.54,7,16,13,13,0.7858751946471527,0.9819805060619657,1.309952797378954,1.2081115874296362,0.915848075416782,5.837769752109657,2.0974157668607614,37.8278439003834,-0.16,27,49,21,4.1328191636431635,Aleatória
